年月日,全国地方公共団体コード,市区名,町名,年齢［歳］,人口総数［人］,男［人］,女［人］
2016/9/30,141097,港北区,－,合計,341098,170342,170756
2016/9/30,141097,港北区,－,0,3481,1774,1707
2016/9/30,141097,港北区,－,1,3409,1750,1659
2016/9/30,141097,港北区,－,2,3276,1684,1592
2016/9/30,141097,港北区,－,3,3087,1547,1540
2016/9/30,141097,港北区,－,4,2980,1522,1458
2016/9/30,141097,港北区,－,5,3004,1581,1423
2016/9/30,141097,港北区,－,6,2809,1460,1349
2016/9/30,141097,港北区,－,7,2722,1294,1428
2016/9/30,141097,港北区,－,8,2784,1443,1341
2016/9/30,141097,港北区,－,9,2733,1430,1303
2016/9/30,141097,港北区,－,10,2646,1351,1295
2016/9/30,141097,港北区,－,11,2585,1293,1292
2016/9/30,141097,港北区,－,12,2693,1384,1309
2016/9/30,141097,港北区,－,13,2703,1337,1366
2016/9/30,141097,港北区,－,14,2802,1440,1362
2016/9/30,141097,港北区,－,15,2741,1451,1290
2016/9/30,141097,港北区,－,16,2847,1412,1435
2016/9/30,141097,港北区,－,17,2821,1412,1409
2016/9/30,141097,港北区,－,18,2998,1496,1502
2016/9/30,141097,港北区,－,19,2981,1507,1474
2016/9/30,141097,港北区,－,20,3232,1674,1558
2016/9/30,141097,港北区,－,21,3449,1787,1662
2016/9/30,141097,港北区,－,22,3770,1931,1839
2016/9/30,141097,港北区,－,23,4017,2016,2001
2016/9/30,141097,港北区,－,24,4181,2079,2102
2016/9/30,141097,港北区,－,25,4183,2175,2008
2016/9/30,141097,港北区,－,26,4522,2268,2254
2016/9/30,141097,港北区,－,27,4667,2301,2366
2016/9/30,141097,港北区,－,28,4890,2466,2424
2016/9/30,141097,港北区,－,29,5030,2579,2451
2016/9/30,141097,港北区,－,30,5224,2659,2565
2016/9/30,141097,港北区,－,31,5484,2763,2721
2016/9/30,141097,港北区,－,32,5467,2864,2603
2016/9/30,141097,港北区,－,33,5485,2858,2627
2016/9/30,141097,港北区,－,34,5485,2873,2612
2016/9/30,141097,港北区,－,35,5443,2816,2627
2016/9/30,141097,港北区,－,36,5553,2904,2649
2016/9/30,141097,港北区,－,37,5625,2889,2736
2016/9/30,141097,港北区,－,38,5707,2962,2745
2016/9/30,141097,港北区,－,39,5727,2960,2767
2016/9/30,141097,港北区,－,40,5969,3050,2919
2016/9/30,141097,港北区,－,41,5947,3075,2872
2016/9/30,141097,港北区,－,42,6282,3221,3061
2016/9/30,141097,港北区,－,43,6192,3218,2974
2016/9/30,141097,港北区,－,44,6162,3148,3014
2016/9/30,141097,港北区,－,45,6228,3142,3086
2016/9/30,141097,港北区,－,46,6111,3174,2937
2016/9/30,141097,港北区,－,47,6094,3153,2941
2016/9/30,141097,港北区,－,48,5907,3132,2775
2016/9/30,141097,港北区,－,49,5822,3066,2756
2016/9/30,141097,港北区,－,50,4514,2373,2141
2016/9/30,141097,港北区,－,51,5414,2866,2548
2016/9/30,141097,港北区,－,52,4891,2537,2354
2016/9/30,141097,港北区,－,53,4635,2433,2202
2016/9/30,141097,港北区,－,54,4380,2315,2065
2016/9/30,141097,港北区,－,55,4149,2126,2023
2016/9/30,141097,港北区,－,56,3959,2050,1909
2016/9/30,141097,港北区,－,57,3746,1940,1806
2016/9/30,141097,港北区,－,58,3633,1837,1796
2016/9/30,141097,港北区,－,59,3249,1677,1572
2016/9/30,141097,港北区,－,60,3336,1669,1667
2016/9/30,141097,港北区,－,61,3363,1750,1613
2016/9/30,141097,港北区,－,62,3208,1612,1596
2016/9/30,141097,港北区,－,63,3312,1692,1620
2016/9/30,141097,港北区,－,64,3535,1733,1802
2016/9/30,141097,港北区,－,65,3570,1775,1795
2016/9/30,141097,港北区,－,66,3832,1919,1913
2016/9/30,141097,港北区,－,67,4282,2087,2195
2016/9/30,141097,港北区,－,68,4335,2154,2181
2016/9/30,141097,港北区,－,69,4018,1937,2081
2016/9/30,141097,港北区,－,70,2582,1237,1345
2016/9/30,141097,港北区,－,71,2751,1292,1459
2016/9/30,141097,港北区,－,72,3123,1422,1701
2016/9/30,141097,港北区,－,73,3162,1446,1716
2016/9/30,141097,港北区,－,74,3043,1357,1686
2016/9/30,141097,港北区,－,75,2922,1308,1614
2016/9/30,141097,港北区,－,76,2690,1211,1479
2016/9/30,141097,港北区,－,77,2211,990,1221
2016/9/30,141097,港北区,－,78,2298,999,1299
2016/9/30,141097,港北区,－,79,2182,926,1256
2016/9/30,141097,港北区,－,80,2295,997,1298
2016/9/30,141097,港北区,－,81,2058,861,1197
2016/9/30,141097,港北区,－,82,1873,721,1152
2016/9/30,141097,港北区,－,83,1732,701,1031
2016/9/30,141097,港北区,－,84,1568,626,942
2016/9/30,141097,港北区,－,85,1466,528,938
2016/9/30,141097,港北区,－,86,1339,474,865
2016/9/30,141097,港北区,－,87,1150,395,755
2016/9/30,141097,港北区,－,88,1025,339,686
2016/9/30,141097,港北区,－,89,846,306,540
2016/9/30,141097,港北区,－,90,771,254,517
2016/9/30,141097,港北区,－,91,683,202,481
2016/9/30,141097,港北区,－,92,492,143,349
2016/9/30,141097,港北区,－,93,375,110,265
2016/9/30,141097,港北区,－,94,324,78,246
2016/9/30,141097,港北区,－,95,240,57,183
2016/9/30,141097,港北区,－,96,179,36,143
2016/9/30,141097,港北区,－,97,113,20,93
2016/9/30,141097,港北区,－,98,98,17,81
2016/9/30,141097,港北区,－,99,56,14,42
2016/9/30,141097,港北区,－,100,133,22,111
2016/9/30,141097,港北区,菊名一丁目,合計,784,368,416
2016/9/30,141097,港北区,菊名一丁目,0,12,5,7
2016/9/30,141097,港北区,菊名一丁目,1,5,1,4
2016/9/30,141097,港北区,菊名一丁目,2,0,0,0
2016/9/30,141097,港北区,菊名一丁目,3,8,2,6
2016/9/30,141097,港北区,菊名一丁目,4,4,2,2
2016/9/30,141097,港北区,菊名一丁目,5,2,0,2
2016/9/30,141097,港北区,菊名一丁目,6,2,2,0
2016/9/30,141097,港北区,菊名一丁目,7,2,1,1
2016/9/30,141097,港北区,菊名一丁目,8,4,2,2
2016/9/30,141097,港北区,菊名一丁目,9,4,2,2
2016/9/30,141097,港北区,菊名一丁目,10,3,2,1
2016/9/30,141097,港北区,菊名一丁目,11,4,2,2
2016/9/30,141097,港北区,菊名一丁目,12,6,1,5
2016/9/30,141097,港北区,菊名一丁目,13,4,1,3
2016/9/30,141097,港北区,菊名一丁目,14,5,2,3
2016/9/30,141097,港北区,菊名一丁目,15,3,1,2
2016/9/30,141097,港北区,菊名一丁目,16,4,2,2
2016/9/30,141097,港北区,菊名一丁目,17,5,2,3
2016/9/30,141097,港北区,菊名一丁目,18,6,2,4
2016/9/30,141097,港北区,菊名一丁目,19,3,1,2
2016/9/30,141097,港北区,菊名一丁目,20,9,4,5
2016/9/30,141097,港北区,菊名一丁目,21,8,5,3
2016/9/30,141097,港北区,菊名一丁目,22,10,5,5
2016/9/30,141097,港北区,菊名一丁目,23,17,10,7
2016/9/30,141097,港北区,菊名一丁目,24,9,3,6
2016/9/30,141097,港北区,菊名一丁目,25,9,2,7
2016/9/30,141097,港北区,菊名一丁目,26,18,9,9
2016/9/30,141097,港北区,菊名一丁目,27,15,12,3
2016/9/30,141097,港北区,菊名一丁目,28,9,5,4
2016/9/30,141097,港北区,菊名一丁目,29,16,9,7
2016/9/30,141097,港北区,菊名一丁目,30,11,6,5
2016/9/30,141097,港北区,菊名一丁目,31,18,5,13
2016/9/30,141097,港北区,菊名一丁目,32,21,9,12
2016/9/30,141097,港北区,菊名一丁目,33,18,13,5
2016/9/30,141097,港北区,菊名一丁目,34,12,7,5
2016/9/30,141097,港北区,菊名一丁目,35,10,5,5
2016/9/30,141097,港北区,菊名一丁目,36,14,6,8
2016/9/30,141097,港北区,菊名一丁目,37,12,5,7
2016/9/30,141097,港北区,菊名一丁目,38,6,4,2
2016/9/30,141097,港北区,菊名一丁目,39,15,7,8
2016/9/30,141097,港北区,菊名一丁目,40,14,10,4
2016/9/30,141097,港北区,菊名一丁目,41,5,4,1
2016/9/30,141097,港北区,菊名一丁目,42,8,4,4
2016/9/30,141097,港北区,菊名一丁目,43,6,3,3
2016/9/30,141097,港北区,菊名一丁目,44,8,5,3
2016/9/30,141097,港北区,菊名一丁目,45,9,5,4
2016/9/30,141097,港北区,菊名一丁目,46,12,7,5
2016/9/30,141097,港北区,菊名一丁目,47,14,5,9
2016/9/30,141097,港北区,菊名一丁目,48,11,5,6
2016/9/30,141097,港北区,菊名一丁目,49,19,12,7
2016/9/30,141097,港北区,菊名一丁目,50,14,7,7
2016/9/30,141097,港北区,菊名一丁目,51,17,7,10
2016/9/30,141097,港北区,菊名一丁目,52,14,6,8
2016/9/30,141097,港北区,菊名一丁目,53,12,8,4
2016/9/30,141097,港北区,菊名一丁目,54,6,3,3
2016/9/30,141097,港北区,菊名一丁目,55,8,6,2
2016/9/30,141097,港北区,菊名一丁目,56,18,9,9
2016/9/30,141097,港北区,菊名一丁目,57,8,3,5
2016/9/30,141097,港北区,菊名一丁目,58,10,4,6
2016/9/30,141097,港北区,菊名一丁目,59,7,5,2
2016/9/30,141097,港北区,菊名一丁目,60,7,3,4
2016/9/30,141097,港北区,菊名一丁目,61,8,2,6
2016/9/30,141097,港北区,菊名一丁目,62,9,3,6
2016/9/30,141097,港北区,菊名一丁目,63,10,4,6
2016/9/30,141097,港北区,菊名一丁目,64,11,4,7
2016/9/30,141097,港北区,菊名一丁目,65,13,6,7
2016/9/30,141097,港北区,菊名一丁目,66,7,4,3
2016/9/30,141097,港北区,菊名一丁目,67,9,4,5
2016/9/30,141097,港北区,菊名一丁目,68,17,6,11
2016/9/30,141097,港北区,菊名一丁目,69,10,6,4
2016/9/30,141097,港北区,菊名一丁目,70,8,3,5
2016/9/30,141097,港北区,菊名一丁目,71,5,1,4
2016/9/30,141097,港北区,菊名一丁目,72,13,4,9
2016/9/30,141097,港北区,菊名一丁目,73,12,7,5
2016/9/30,141097,港北区,菊名一丁目,74,8,3,5
2016/9/30,141097,港北区,菊名一丁目,75,4,3,1
2016/9/30,141097,港北区,菊名一丁目,76,7,3,4
2016/9/30,141097,港北区,菊名一丁目,77,6,3,3
2016/9/30,141097,港北区,菊名一丁目,78,8,3,5
2016/9/30,141097,港北区,菊名一丁目,79,0,0,0
2016/9/30,141097,港北区,菊名一丁目,80,4,2,2
2016/9/30,141097,港北区,菊名一丁目,81,4,1,3
2016/9/30,141097,港北区,菊名一丁目,82,8,4,4
2016/9/30,141097,港北区,菊名一丁目,83,5,0,5
2016/9/30,141097,港北区,菊名一丁目,84,3,2,1
2016/9/30,141097,港北区,菊名一丁目,85,1,1,0
2016/9/30,141097,港北区,菊名一丁目,86,1,0,1
2016/9/30,141097,港北区,菊名一丁目,87,4,1,3
2016/9/30,141097,港北区,菊名一丁目,88,2,1,1
2016/9/30,141097,港北区,菊名一丁目,89,3,0,3
2016/9/30,141097,港北区,菊名一丁目,90,5,1,4
2016/9/30,141097,港北区,菊名一丁目,91,1,0,1
2016/9/30,141097,港北区,菊名一丁目,92,1,0,1
2016/9/30,141097,港北区,菊名一丁目,93,0,0,0
2016/9/30,141097,港北区,菊名一丁目,94,2,0,2
2016/9/30,141097,港北区,菊名一丁目,95,1,0,1
2016/9/30,141097,港北区,菊名一丁目,96,0,0,0
2016/9/30,141097,港北区,菊名一丁目,97,1,0,1
2016/9/30,141097,港北区,菊名一丁目,98,0,0,0
2016/9/30,141097,港北区,菊名一丁目,99,0,0,0
2016/9/30,141097,港北区,菊名一丁目,100,3,1,2
2016/9/30,141097,港北区,菊名二丁目,合計,2263,1098,1165
2016/9/30,141097,港北区,菊名二丁目,0,24,12,12
2016/9/30,141097,港北区,菊名二丁目,1,25,16,9
2016/9/30,141097,港北区,菊名二丁目,2,30,10,20
2016/9/30,141097,港北区,菊名二丁目,3,17,7,10
2016/9/30,141097,港北区,菊名二丁目,4,27,13,14
2016/9/30,141097,港北区,菊名二丁目,5,24,16,8
2016/9/30,141097,港北区,菊名二丁目,6,23,12,11
2016/9/30,141097,港北区,菊名二丁目,7,36,15,21
2016/9/30,141097,港北区,菊名二丁目,8,13,4,9
2016/9/30,141097,港北区,菊名二丁目,9,15,9,6
2016/9/30,141097,港北区,菊名二丁目,10,20,10,10
2016/9/30,141097,港北区,菊名二丁目,11,22,13,9
2016/9/30,141097,港北区,菊名二丁目,12,15,9,6
2016/9/30,141097,港北区,菊名二丁目,13,8,7,1
2016/9/30,141097,港北区,菊名二丁目,14,12,9,3
2016/9/30,141097,港北区,菊名二丁目,15,17,9,8
2016/9/30,141097,港北区,菊名二丁目,16,22,8,14
2016/9/30,141097,港北区,菊名二丁目,17,16,9,7
2016/9/30,141097,港北区,菊名二丁目,18,19,10,9
2016/9/30,141097,港北区,菊名二丁目,19,15,11,4
2016/9/30,141097,港北区,菊名二丁目,20,20,10,10
2016/9/30,141097,港北区,菊名二丁目,21,27,14,13
2016/9/30,141097,港北区,菊名二丁目,22,19,10,9
2016/9/30,141097,港北区,菊名二丁目,23,22,6,16
2016/9/30,141097,港北区,菊名二丁目,24,26,12,14
2016/9/30,141097,港北区,菊名二丁目,25,22,12,10
2016/9/30,141097,港北区,菊名二丁目,26,24,12,12
2016/9/30,141097,港北区,菊名二丁目,27,15,6,9
2016/9/30,141097,港北区,菊名二丁目,28,28,14,14
2016/9/30,141097,港北区,菊名二丁目,29,31,15,16
2016/9/30,141097,港北区,菊名二丁目,30,37,18,19
2016/9/30,141097,港北区,菊名二丁目,31,45,22,23
2016/9/30,141097,港北区,菊名二丁目,32,36,14,22
2016/9/30,141097,港北区,菊名二丁目,33,43,22,21
2016/9/30,141097,港北区,菊名二丁目,34,45,21,24
2016/9/30,141097,港北区,菊名二丁目,35,34,18,16
2016/9/30,141097,港北区,菊名二丁目,36,36,17,19
2016/9/30,141097,港北区,菊名二丁目,37,36,20,16
2016/9/30,141097,港北区,菊名二丁目,38,48,21,27
2016/9/30,141097,港北区,菊名二丁目,39,42,25,17
2016/9/30,141097,港北区,菊名二丁目,40,47,24,23
2016/9/30,141097,港北区,菊名二丁目,41,30,13,17
2016/9/30,141097,港北区,菊名二丁目,42,38,17,21
2016/9/30,141097,港北区,菊名二丁目,43,34,16,18
2016/9/30,141097,港北区,菊名二丁目,44,38,18,20
2016/9/30,141097,港北区,菊名二丁目,45,50,24,26
2016/9/30,141097,港北区,菊名二丁目,46,46,21,25
2016/9/30,141097,港北区,菊名二丁目,47,38,24,14
2016/9/30,141097,港北区,菊名二丁目,48,28,14,14
2016/9/30,141097,港北区,菊名二丁目,49,40,26,14
2016/9/30,141097,港北区,菊名二丁目,50,20,9,11
2016/9/30,141097,港北区,菊名二丁目,51,36,22,14
2016/9/30,141097,港北区,菊名二丁目,52,29,15,14
2016/9/30,141097,港北区,菊名二丁目,53,30,18,12
2016/9/30,141097,港北区,菊名二丁目,54,36,17,19
2016/9/30,141097,港北区,菊名二丁目,55,35,17,18
2016/9/30,141097,港北区,菊名二丁目,56,18,6,12
2016/9/30,141097,港北区,菊名二丁目,57,21,9,12
2016/9/30,141097,港北区,菊名二丁目,58,19,9,10
2016/9/30,141097,港北区,菊名二丁目,59,31,17,14
2016/9/30,141097,港北区,菊名二丁目,60,26,13,13
2016/9/30,141097,港北区,菊名二丁目,61,26,11,15
2016/9/30,141097,港北区,菊名二丁目,62,18,6,12
2016/9/30,141097,港北区,菊名二丁目,63,26,17,9
2016/9/30,141097,港北区,菊名二丁目,64,30,13,17
2016/9/30,141097,港北区,菊名二丁目,65,20,14,6
2016/9/30,141097,港北区,菊名二丁目,66,19,6,13
2016/9/30,141097,港北区,菊名二丁目,67,36,18,18
2016/9/30,141097,港北区,菊名二丁目,68,26,17,9
2016/9/30,141097,港北区,菊名二丁目,69,27,15,12
2016/9/30,141097,港北区,菊名二丁目,70,24,10,14
2016/9/30,141097,港北区,菊名二丁目,71,17,6,11
2016/9/30,141097,港北区,菊名二丁目,72,25,11,14
2016/9/30,141097,港北区,菊名二丁目,73,28,12,16
2016/9/30,141097,港北区,菊名二丁目,74,12,3,9
2016/9/30,141097,港北区,菊名二丁目,75,13,4,9
2016/9/30,141097,港北区,菊名二丁目,76,17,8,9
2016/9/30,141097,港北区,菊名二丁目,77,14,6,8
2016/9/30,141097,港北区,菊名二丁目,78,14,5,9
2016/9/30,141097,港北区,菊名二丁目,79,10,3,7
2016/9/30,141097,港北区,菊名二丁目,80,14,6,8
2016/9/30,141097,港北区,菊名二丁目,81,16,6,10
2016/9/30,141097,港北区,菊名二丁目,82,8,8,0
2016/9/30,141097,港北区,菊名二丁目,83,11,4,7
2016/9/30,141097,港北区,菊名二丁目,84,12,3,9
2016/9/30,141097,港北区,菊名二丁目,85,10,3,7
2016/9/30,141097,港北区,菊名二丁目,86,8,1,7
2016/9/30,141097,港北区,菊名二丁目,87,9,4,5
2016/9/30,141097,港北区,菊名二丁目,88,9,3,6
2016/9/30,141097,港北区,菊名二丁目,89,6,3,3
2016/9/30,141097,港北区,菊名二丁目,90,5,1,4
2016/9/30,141097,港北区,菊名二丁目,91,4,0,4
2016/9/30,141097,港北区,菊名二丁目,92,5,3,2
2016/9/30,141097,港北区,菊名二丁目,93,4,0,4
2016/9/30,141097,港北区,菊名二丁目,94,3,0,3
2016/9/30,141097,港北区,菊名二丁目,95,5,0,5
2016/9/30,141097,港北区,菊名二丁目,96,2,0,2
2016/9/30,141097,港北区,菊名二丁目,97,0,0,0
2016/9/30,141097,港北区,菊名二丁目,98,2,1,1
2016/9/30,141097,港北区,菊名二丁目,99,0,0,0
2016/9/30,141097,港北区,菊名二丁目,100,2,0,2
2016/9/30,141097,港北区,菊名三丁目,合計,2840,1391,1449
2016/9/30,141097,港北区,菊名三丁目,0,24,12,12
2016/9/30,141097,港北区,菊名三丁目,1,25,15,10
2016/9/30,141097,港北区,菊名三丁目,2,32,15,17
2016/9/30,141097,港北区,菊名三丁目,3,30,11,19
2016/9/30,141097,港北区,菊名三丁目,4,32,17,15
2016/9/30,141097,港北区,菊名三丁目,5,20,9,11
2016/9/30,141097,港北区,菊名三丁目,6,16,9,7
2016/9/30,141097,港北区,菊名三丁目,7,30,15,15
2016/9/30,141097,港北区,菊名三丁目,8,19,11,8
2016/9/30,141097,港北区,菊名三丁目,9,17,9,8
2016/9/30,141097,港北区,菊名三丁目,10,14,7,7
2016/9/30,141097,港北区,菊名三丁目,11,14,10,4
2016/9/30,141097,港北区,菊名三丁目,12,21,12,9
2016/9/30,141097,港北区,菊名三丁目,13,18,6,12
2016/9/30,141097,港北区,菊名三丁目,14,15,9,6
2016/9/30,141097,港北区,菊名三丁目,15,26,12,14
2016/9/30,141097,港北区,菊名三丁目,16,37,13,24
2016/9/30,141097,港北区,菊名三丁目,17,23,12,11
2016/9/30,141097,港北区,菊名三丁目,18,19,11,8
2016/9/30,141097,港北区,菊名三丁目,19,22,9,13
2016/9/30,141097,港北区,菊名三丁目,20,26,14,12
2016/9/30,141097,港北区,菊名三丁目,21,25,16,9
2016/9/30,141097,港北区,菊名三丁目,22,48,22,26
2016/9/30,141097,港北区,菊名三丁目,23,40,19,21
2016/9/30,141097,港北区,菊名三丁目,24,37,14,23
2016/9/30,141097,港北区,菊名三丁目,25,44,20,24
2016/9/30,141097,港北区,菊名三丁目,26,59,27,32
2016/9/30,141097,港北区,菊名三丁目,27,32,16,16
2016/9/30,141097,港北区,菊名三丁目,28,49,26,23
2016/9/30,141097,港北区,菊名三丁目,29,48,21,27
2016/9/30,141097,港北区,菊名三丁目,30,41,22,19
2016/9/30,141097,港北区,菊名三丁目,31,47,23,24
2016/9/30,141097,港北区,菊名三丁目,32,44,22,22
2016/9/30,141097,港北区,菊名三丁目,33,51,22,29
2016/9/30,141097,港北区,菊名三丁目,34,40,23,17
2016/9/30,141097,港北区,菊名三丁目,35,44,20,24
2016/9/30,141097,港北区,菊名三丁目,36,55,30,25
2016/9/30,141097,港北区,菊名三丁目,37,38,23,15
2016/9/30,141097,港北区,菊名三丁目,38,47,23,24
2016/9/30,141097,港北区,菊名三丁目,39,48,23,25
2016/9/30,141097,港北区,菊名三丁目,40,53,26,27
2016/9/30,141097,港北区,菊名三丁目,41,46,31,15
2016/9/30,141097,港北区,菊名三丁目,42,45,19,26
2016/9/30,141097,港北区,菊名三丁目,43,45,21,24
2016/9/30,141097,港北区,菊名三丁目,44,37,16,21
2016/9/30,141097,港北区,菊名三丁目,45,48,25,23
2016/9/30,141097,港北区,菊名三丁目,46,51,23,28
2016/9/30,141097,港北区,菊名三丁目,47,63,31,32
2016/9/30,141097,港北区,菊名三丁目,48,57,30,27
2016/9/30,141097,港北区,菊名三丁目,49,44,21,23
2016/9/30,141097,港北区,菊名三丁目,50,40,20,20
2016/9/30,141097,港北区,菊名三丁目,51,43,24,19
2016/9/30,141097,港北区,菊名三丁目,52,31,18,13
2016/9/30,141097,港北区,菊名三丁目,53,44,22,22
2016/9/30,141097,港北区,菊名三丁目,54,38,12,26
2016/9/30,141097,港北区,菊名三丁目,55,36,19,17
2016/9/30,141097,港北区,菊名三丁目,56,37,17,20
2016/9/30,141097,港北区,菊名三丁目,57,35,18,17
2016/9/30,141097,港北区,菊名三丁目,58,46,24,22
2016/9/30,141097,港北区,菊名三丁目,59,33,18,15
2016/9/30,141097,港北区,菊名三丁目,60,31,19,12
2016/9/30,141097,港北区,菊名三丁目,61,23,11,12
2016/9/30,141097,港北区,菊名三丁目,62,21,12,9
2016/9/30,141097,港北区,菊名三丁目,63,25,12,13
2016/9/30,141097,港北区,菊名三丁目,64,35,14,21
2016/9/30,141097,港北区,菊名三丁目,65,35,18,17
2016/9/30,141097,港北区,菊名三丁目,66,34,14,20
2016/9/30,141097,港北区,菊名三丁目,67,33,16,17
2016/9/30,141097,港北区,菊名三丁目,68,43,26,17
2016/9/30,141097,港北区,菊名三丁目,69,28,14,14
2016/9/30,141097,港北区,菊名三丁目,70,20,9,11
2016/9/30,141097,港北区,菊名三丁目,71,25,13,12
2016/9/30,141097,港北区,菊名三丁目,72,31,15,16
2016/9/30,141097,港北区,菊名三丁目,73,24,12,12
2016/9/30,141097,港北区,菊名三丁目,74,15,10,5
2016/9/30,141097,港北区,菊名三丁目,75,13,9,4
2016/9/30,141097,港北区,菊名三丁目,76,21,9,12
2016/9/30,141097,港北区,菊名三丁目,77,18,9,9
2016/9/30,141097,港北区,菊名三丁目,78,18,7,11
2016/9/30,141097,港北区,菊名三丁目,79,15,8,7
2016/9/30,141097,港北区,菊名三丁目,80,16,7,9
2016/9/30,141097,港北区,菊名三丁目,81,14,6,8
2016/9/30,141097,港北区,菊名三丁目,82,10,6,4
2016/9/30,141097,港北区,菊名三丁目,83,14,6,8
2016/9/30,141097,港北区,菊名三丁目,84,9,3,6
2016/9/30,141097,港北区,菊名三丁目,85,9,2,7
2016/9/30,141097,港北区,菊名三丁目,86,12,4,8
2016/9/30,141097,港北区,菊名三丁目,87,6,2,4
2016/9/30,141097,港北区,菊名三丁目,88,5,1,4
2016/9/30,141097,港北区,菊名三丁目,89,13,4,9
2016/9/30,141097,港北区,菊名三丁目,90,6,4,2
2016/9/30,141097,港北区,菊名三丁目,91,5,1,4
2016/9/30,141097,港北区,菊名三丁目,92,8,0,8
2016/9/30,141097,港北区,菊名三丁目,93,4,0,4
2016/9/30,141097,港北区,菊名三丁目,94,4,2,2
2016/9/30,141097,港北区,菊名三丁目,95,2,0,2
2016/9/30,141097,港北区,菊名三丁目,96,3,0,3
2016/9/30,141097,港北区,菊名三丁目,97,0,0,0
2016/9/30,141097,港北区,菊名三丁目,98,1,1,0
2016/9/30,141097,港北区,菊名三丁目,99,2,0,2
2016/9/30,141097,港北区,菊名三丁目,100,0,0,0
2016/9/30,141097,港北区,菊名四丁目,合計,1701,847,854
2016/9/30,141097,港北区,菊名四丁目,0,20,10,10
2016/9/30,141097,港北区,菊名四丁目,1,15,5,10
2016/9/30,141097,港北区,菊名四丁目,2,14,4,10
2016/9/30,141097,港北区,菊名四丁目,3,20,11,9
2016/9/30,141097,港北区,菊名四丁目,4,24,14,10
2016/9/30,141097,港北区,菊名四丁目,5,20,9,11
2016/9/30,141097,港北区,菊名四丁目,6,11,4,7
2016/9/30,141097,港北区,菊名四丁目,7,24,11,13
2016/9/30,141097,港北区,菊名四丁目,8,13,6,7
2016/9/30,141097,港北区,菊名四丁目,9,14,8,6
2016/9/30,141097,港北区,菊名四丁目,10,12,10,2
2016/9/30,141097,港北区,菊名四丁目,11,11,7,4
2016/9/30,141097,港北区,菊名四丁目,12,8,4,4
2016/9/30,141097,港北区,菊名四丁目,13,7,5,2
2016/9/30,141097,港北区,菊名四丁目,14,11,5,6
2016/9/30,141097,港北区,菊名四丁目,15,10,4,6
2016/9/30,141097,港北区,菊名四丁目,16,8,3,5
2016/9/30,141097,港北区,菊名四丁目,17,8,3,5
2016/9/30,141097,港北区,菊名四丁目,18,12,11,1
2016/9/30,141097,港北区,菊名四丁目,19,19,14,5
2016/9/30,141097,港北区,菊名四丁目,20,14,7,7
2016/9/30,141097,港北区,菊名四丁目,21,13,5,8
2016/9/30,141097,港北区,菊名四丁目,22,16,6,10
2016/9/30,141097,港北区,菊名四丁目,23,32,15,17
2016/9/30,141097,港北区,菊名四丁目,24,23,18,5
2016/9/30,141097,港北区,菊名四丁目,25,36,20,16
2016/9/30,141097,港北区,菊名四丁目,26,32,17,15
2016/9/30,141097,港北区,菊名四丁目,27,33,15,18
2016/9/30,141097,港北区,菊名四丁目,28,26,14,12
2016/9/30,141097,港北区,菊名四丁目,29,33,16,17
2016/9/30,141097,港北区,菊名四丁目,30,29,19,10
2016/9/30,141097,港北区,菊名四丁目,31,31,14,17
2016/9/30,141097,港北区,菊名四丁目,32,33,11,22
2016/9/30,141097,港北区,菊名四丁目,33,34,18,16
2016/9/30,141097,港北区,菊名四丁目,34,27,15,12
2016/9/30,141097,港北区,菊名四丁目,35,45,26,19
2016/9/30,141097,港北区,菊名四丁目,36,43,20,23
2016/9/30,141097,港北区,菊名四丁目,37,31,10,21
2016/9/30,141097,港北区,菊名四丁目,38,35,23,12
2016/9/30,141097,港北区,菊名四丁目,39,32,12,20
2016/9/30,141097,港北区,菊名四丁目,40,29,15,14
2016/9/30,141097,港北区,菊名四丁目,41,30,12,18
2016/9/30,141097,港北区,菊名四丁目,42,40,26,14
2016/9/30,141097,港北区,菊名四丁目,43,34,18,16
2016/9/30,141097,港北区,菊名四丁目,44,23,7,16
2016/9/30,141097,港北区,菊名四丁目,45,37,15,22
2016/9/30,141097,港北区,菊名四丁目,46,26,15,11
2016/9/30,141097,港北区,菊名四丁目,47,28,18,10
2016/9/30,141097,港北区,菊名四丁目,48,20,12,8
2016/9/30,141097,港北区,菊名四丁目,49,34,18,16
2016/9/30,141097,港北区,菊名四丁目,50,14,7,7
2016/9/30,141097,港北区,菊名四丁目,51,20,10,10
2016/9/30,141097,港北区,菊名四丁目,52,16,9,7
2016/9/30,141097,港北区,菊名四丁目,53,18,5,13
2016/9/30,141097,港北区,菊名四丁目,54,13,6,7
2016/9/30,141097,港北区,菊名四丁目,55,14,7,7
2016/9/30,141097,港北区,菊名四丁目,56,18,8,10
2016/9/30,141097,港北区,菊名四丁目,57,14,10,4
2016/9/30,141097,港北区,菊名四丁目,58,13,9,4
2016/9/30,141097,港北区,菊名四丁目,59,18,11,7
2016/9/30,141097,港北区,菊名四丁目,60,5,4,1
2016/9/30,141097,港北区,菊名四丁目,61,13,8,5
2016/9/30,141097,港北区,菊名四丁目,62,9,6,3
2016/9/30,141097,港北区,菊名四丁目,63,15,11,4
2016/9/30,141097,港北区,菊名四丁目,64,15,6,9
2016/9/30,141097,港北区,菊名四丁目,65,12,6,6
2016/9/30,141097,港北区,菊名四丁目,66,11,5,6
2016/9/30,141097,港北区,菊名四丁目,67,20,9,11
2016/9/30,141097,港北区,菊名四丁目,68,19,10,9
2016/9/30,141097,港北区,菊名四丁目,69,22,10,12
2016/9/30,141097,港北区,菊名四丁目,70,16,7,9
2016/9/30,141097,港北区,菊名四丁目,71,12,5,7
2016/9/30,141097,港北区,菊名四丁目,72,13,8,5
2016/9/30,141097,港北区,菊名四丁目,73,11,7,4
2016/9/30,141097,港北区,菊名四丁目,74,13,4,9
2016/9/30,141097,港北区,菊名四丁目,75,13,5,8
2016/9/30,141097,港北区,菊名四丁目,76,13,4,9
2016/9/30,141097,港北区,菊名四丁目,77,14,2,12
2016/9/30,141097,港北区,菊名四丁目,78,6,3,3
2016/9/30,141097,港北区,菊名四丁目,79,17,6,11
2016/9/30,141097,港北区,菊名四丁目,80,9,5,4
2016/9/30,141097,港北区,菊名四丁目,81,10,4,6
2016/9/30,141097,港北区,菊名四丁目,82,10,3,7
2016/9/30,141097,港北区,菊名四丁目,83,14,5,9
2016/9/30,141097,港北区,菊名四丁目,84,4,2,2
2016/9/30,141097,港北区,菊名四丁目,85,5,2,3
2016/9/30,141097,港北区,菊名四丁目,86,4,0,4
2016/9/30,141097,港北区,菊名四丁目,87,4,1,3
2016/9/30,141097,港北区,菊名四丁目,88,3,0,3
2016/9/30,141097,港北区,菊名四丁目,89,6,2,4
2016/9/30,141097,港北区,菊名四丁目,90,5,2,3
2016/9/30,141097,港北区,菊名四丁目,91,4,2,2
2016/9/30,141097,港北区,菊名四丁目,92,5,3,2
2016/9/30,141097,港北区,菊名四丁目,93,1,1,0
2016/9/30,141097,港北区,菊名四丁目,94,6,2,4
2016/9/30,141097,港北区,菊名四丁目,95,2,0,2
2016/9/30,141097,港北区,菊名四丁目,96,0,0,0
2016/9/30,141097,港北区,菊名四丁目,97,0,0,0
2016/9/30,141097,港北区,菊名四丁目,98,1,0,1
2016/9/30,141097,港北区,菊名四丁目,99,0,0,0
2016/9/30,141097,港北区,菊名四丁目,100,1,0,1
2016/9/30,141097,港北区,菊名五丁目,合計,1979,951,1028
2016/9/30,141097,港北区,菊名五丁目,0,12,7,5
2016/9/30,141097,港北区,菊名五丁目,1,18,6,12
2016/9/30,141097,港北区,菊名五丁目,2,8,6,2
2016/9/30,141097,港北区,菊名五丁目,3,14,11,3
2016/9/30,141097,港北区,菊名五丁目,4,14,5,9
2016/9/30,141097,港北区,菊名五丁目,5,14,11,3
2016/9/30,141097,港北区,菊名五丁目,6,16,7,9
2016/9/30,141097,港北区,菊名五丁目,7,9,3,6
2016/9/30,141097,港北区,菊名五丁目,8,8,4,4
2016/9/30,141097,港北区,菊名五丁目,9,16,1,15
2016/9/30,141097,港北区,菊名五丁目,10,12,5,7
2016/9/30,141097,港北区,菊名五丁目,11,12,6,6
2016/9/30,141097,港北区,菊名五丁目,12,15,9,6
2016/9/30,141097,港北区,菊名五丁目,13,8,4,4
2016/9/30,141097,港北区,菊名五丁目,14,14,8,6
2016/9/30,141097,港北区,菊名五丁目,15,10,6,4
2016/9/30,141097,港北区,菊名五丁目,16,17,7,10
2016/9/30,141097,港北区,菊名五丁目,17,18,7,11
2016/9/30,141097,港北区,菊名五丁目,18,29,11,18
2016/9/30,141097,港北区,菊名五丁目,19,10,7,3
2016/9/30,141097,港北区,菊名五丁目,20,21,14,7
2016/9/30,141097,港北区,菊名五丁目,21,20,9,11
2016/9/30,141097,港北区,菊名五丁目,22,29,14,15
2016/9/30,141097,港北区,菊名五丁目,23,31,13,18
2016/9/30,141097,港北区,菊名五丁目,24,29,14,15
2016/9/30,141097,港北区,菊名五丁目,25,37,18,19
2016/9/30,141097,港北区,菊名五丁目,26,36,22,14
2016/9/30,141097,港北区,菊名五丁目,27,34,19,15
2016/9/30,141097,港北区,菊名五丁目,28,37,17,20
2016/9/30,141097,港北区,菊名五丁目,29,32,20,12
2016/9/30,141097,港北区,菊名五丁目,30,28,12,16
2016/9/30,141097,港北区,菊名五丁目,31,39,19,20
2016/9/30,141097,港北区,菊名五丁目,32,25,13,12
2016/9/30,141097,港北区,菊名五丁目,33,28,13,15
2016/9/30,141097,港北区,菊名五丁目,34,32,16,16
2016/9/30,141097,港北区,菊名五丁目,35,27,14,13
2016/9/30,141097,港北区,菊名五丁目,36,23,13,10
2016/9/30,141097,港北区,菊名五丁目,37,23,12,11
2016/9/30,141097,港北区,菊名五丁目,38,30,15,15
2016/9/30,141097,港北区,菊名五丁目,39,25,11,14
2016/9/30,141097,港北区,菊名五丁目,40,47,29,18
2016/9/30,141097,港北区,菊名五丁目,41,40,19,21
2016/9/30,141097,港北区,菊名五丁目,42,29,15,14
2016/9/30,141097,港北区,菊名五丁目,43,31,18,13
2016/9/30,141097,港北区,菊名五丁目,44,38,14,24
2016/9/30,141097,港北区,菊名五丁目,45,38,22,16
2016/9/30,141097,港北区,菊名五丁目,46,50,22,28
2016/9/30,141097,港北区,菊名五丁目,47,31,12,19
2016/9/30,141097,港北区,菊名五丁目,48,31,16,15
2016/9/30,141097,港北区,菊名五丁目,49,26,12,14
2016/9/30,141097,港北区,菊名五丁目,50,34,18,16
2016/9/30,141097,港北区,菊名五丁目,51,33,19,14
2016/9/30,141097,港北区,菊名五丁目,52,15,7,8
2016/9/30,141097,港北区,菊名五丁目,53,20,9,11
2016/9/30,141097,港北区,菊名五丁目,54,25,14,11
2016/9/30,141097,港北区,菊名五丁目,55,24,10,14
2016/9/30,141097,港北区,菊名五丁目,56,16,6,10
2016/9/30,141097,港北区,菊名五丁目,57,21,11,10
2016/9/30,141097,港北区,菊名五丁目,58,27,12,15
2016/9/30,141097,港北区,菊名五丁目,59,14,8,6
2016/9/30,141097,港北区,菊名五丁目,60,30,15,15
2016/9/30,141097,港北区,菊名五丁目,61,17,9,8
2016/9/30,141097,港北区,菊名五丁目,62,13,8,5
2016/9/30,141097,港北区,菊名五丁目,63,17,11,6
2016/9/30,141097,港北区,菊名五丁目,64,19,8,11
2016/9/30,141097,港北区,菊名五丁目,65,22,11,11
2016/9/30,141097,港北区,菊名五丁目,66,20,11,9
2016/9/30,141097,港北区,菊名五丁目,67,28,10,18
2016/9/30,141097,港北区,菊名五丁目,68,23,11,12
2016/9/30,141097,港北区,菊名五丁目,69,32,15,17
2016/9/30,141097,港北区,菊名五丁目,70,9,2,7
2016/9/30,141097,港北区,菊名五丁目,71,21,9,12
2016/9/30,141097,港北区,菊名五丁目,72,15,8,7
2016/9/30,141097,港北区,菊名五丁目,73,17,3,14
2016/9/30,141097,港北区,菊名五丁目,74,15,5,10
2016/9/30,141097,港北区,菊名五丁目,75,18,8,10
2016/9/30,141097,港北区,菊名五丁目,76,17,10,7
2016/9/30,141097,港北区,菊名五丁目,77,16,7,9
2016/9/30,141097,港北区,菊名五丁目,78,21,11,10
2016/9/30,141097,港北区,菊名五丁目,79,14,5,9
2016/9/30,141097,港北区,菊名五丁目,80,19,12,7
2016/9/30,141097,港北区,菊名五丁目,81,16,5,11
2016/9/30,141097,港北区,菊名五丁目,82,13,6,7
2016/9/30,141097,港北区,菊名五丁目,83,13,6,7
2016/9/30,141097,港北区,菊名五丁目,84,8,1,7
2016/9/30,141097,港北区,菊名五丁目,85,10,3,7
2016/9/30,141097,港北区,菊名五丁目,86,8,2,6
2016/9/30,141097,港北区,菊名五丁目,87,10,6,4
2016/9/30,141097,港北区,菊名五丁目,88,7,5,2
2016/9/30,141097,港北区,菊名五丁目,89,5,3,2
2016/9/30,141097,港北区,菊名五丁目,90,7,2,5
2016/9/30,141097,港北区,菊名五丁目,91,7,0,7
2016/9/30,141097,港北区,菊名五丁目,92,6,0,6
2016/9/30,141097,港北区,菊名五丁目,93,1,0,1
2016/9/30,141097,港北区,菊名五丁目,94,4,0,4
2016/9/30,141097,港北区,菊名五丁目,95,6,1,5
2016/9/30,141097,港北区,菊名五丁目,96,2,0,2
2016/9/30,141097,港北区,菊名五丁目,97,1,0,1
2016/9/30,141097,港北区,菊名五丁目,98,0,0,0
2016/9/30,141097,港北区,菊名五丁目,99,0,0,0
2016/9/30,141097,港北区,菊名五丁目,100,2,0,2
2016/9/30,141097,港北区,菊名六丁目,合計,2738,1288,1450
2016/9/30,141097,港北区,菊名六丁目,0,23,12,11
2016/9/30,141097,港北区,菊名六丁目,1,29,19,10
2016/9/30,141097,港北区,菊名六丁目,2,20,6,14
2016/9/30,141097,港北区,菊名六丁目,3,17,8,9
2016/9/30,141097,港北区,菊名六丁目,4,15,8,7
2016/9/30,141097,港北区,菊名六丁目,5,14,7,7
2016/9/30,141097,港北区,菊名六丁目,6,14,6,8
2016/9/30,141097,港北区,菊名六丁目,7,18,5,13
2016/9/30,141097,港北区,菊名六丁目,8,12,8,4
2016/9/30,141097,港北区,菊名六丁目,9,14,8,6
2016/9/30,141097,港北区,菊名六丁目,10,14,7,7
2016/9/30,141097,港北区,菊名六丁目,11,17,7,10
2016/9/30,141097,港北区,菊名六丁目,12,18,6,12
2016/9/30,141097,港北区,菊名六丁目,13,14,3,11
2016/9/30,141097,港北区,菊名六丁目,14,11,7,4
2016/9/30,141097,港北区,菊名六丁目,15,15,9,6
2016/9/30,141097,港北区,菊名六丁目,16,13,5,8
2016/9/30,141097,港北区,菊名六丁目,17,20,13,7
2016/9/30,141097,港北区,菊名六丁目,18,21,12,9
2016/9/30,141097,港北区,菊名六丁目,19,26,11,15
2016/9/30,141097,港北区,菊名六丁目,20,22,10,12
2016/9/30,141097,港北区,菊名六丁目,21,22,7,15
2016/9/30,141097,港北区,菊名六丁目,22,33,17,16
2016/9/30,141097,港北区,菊名六丁目,23,50,17,33
2016/9/30,141097,港北区,菊名六丁目,24,55,21,34
2016/9/30,141097,港北区,菊名六丁目,25,41,23,18
2016/9/30,141097,港北区,菊名六丁目,26,53,21,32
2016/9/30,141097,港北区,菊名六丁目,27,64,31,33
2016/9/30,141097,港北区,菊名六丁目,28,50,24,26
2016/9/30,141097,港北区,菊名六丁目,29,40,22,18
2016/9/30,141097,港北区,菊名六丁目,30,48,18,30
2016/9/30,141097,港北区,菊名六丁目,31,61,29,32
2016/9/30,141097,港北区,菊名六丁目,32,54,27,27
2016/9/30,141097,港北区,菊名六丁目,33,58,32,26
2016/9/30,141097,港北区,菊名六丁目,34,60,33,27
2016/9/30,141097,港北区,菊名六丁目,35,48,26,22
2016/9/30,141097,港北区,菊名六丁目,36,66,33,33
2016/9/30,141097,港北区,菊名六丁目,37,37,21,16
2016/9/30,141097,港北区,菊名六丁目,38,40,21,19
2016/9/30,141097,港北区,菊名六丁目,39,36,17,19
2016/9/30,141097,港北区,菊名六丁目,40,52,22,30
2016/9/30,141097,港北区,菊名六丁目,41,45,22,23
2016/9/30,141097,港北区,菊名六丁目,42,50,26,24
2016/9/30,141097,港北区,菊名六丁目,43,53,26,27
2016/9/30,141097,港北区,菊名六丁目,44,44,22,22
2016/9/30,141097,港北区,菊名六丁目,45,42,22,20
2016/9/30,141097,港北区,菊名六丁目,46,42,21,21
2016/9/30,141097,港北区,菊名六丁目,47,41,16,25
2016/9/30,141097,港北区,菊名六丁目,48,44,23,21
2016/9/30,141097,港北区,菊名六丁目,49,38,14,24
2016/9/30,141097,港北区,菊名六丁目,50,36,20,16
2016/9/30,141097,港北区,菊名六丁目,51,36,20,16
2016/9/30,141097,港北区,菊名六丁目,52,35,18,17
2016/9/30,141097,港北区,菊名六丁目,53,45,21,24
2016/9/30,141097,港北区,菊名六丁目,54,37,20,17
2016/9/30,141097,港北区,菊名六丁目,55,31,18,13
2016/9/30,141097,港北区,菊名六丁目,56,36,16,20
2016/9/30,141097,港北区,菊名六丁目,57,29,11,18
2016/9/30,141097,港北区,菊名六丁目,58,29,15,14
2016/9/30,141097,港北区,菊名六丁目,59,27,11,16
2016/9/30,141097,港北区,菊名六丁目,60,28,14,14
2016/9/30,141097,港北区,菊名六丁目,61,27,13,14
2016/9/30,141097,港北区,菊名六丁目,62,32,20,12
2016/9/30,141097,港北区,菊名六丁目,63,23,12,11
2016/9/30,141097,港北区,菊名六丁目,64,35,18,17
2016/9/30,141097,港北区,菊名六丁目,65,27,13,14
2016/9/30,141097,港北区,菊名六丁目,66,21,14,7
2016/9/30,141097,港北区,菊名六丁目,67,31,14,17
2016/9/30,141097,港北区,菊名六丁目,68,42,20,22
2016/9/30,141097,港北区,菊名六丁目,69,33,20,13
2016/9/30,141097,港北区,菊名六丁目,70,12,5,7
2016/9/30,141097,港北区,菊名六丁目,71,19,11,8
2016/9/30,141097,港北区,菊名六丁目,72,28,14,14
2016/9/30,141097,港北区,菊名六丁目,73,27,12,15
2016/9/30,141097,港北区,菊名六丁目,74,21,8,13
2016/9/30,141097,港北区,菊名六丁目,75,21,11,10
2016/9/30,141097,港北区,菊名六丁目,76,22,4,18
2016/9/30,141097,港北区,菊名六丁目,77,19,10,9
2016/9/30,141097,港北区,菊名六丁目,78,22,6,16
2016/9/30,141097,港北区,菊名六丁目,79,12,6,6
2016/9/30,141097,港北区,菊名六丁目,80,27,10,17
2016/9/30,141097,港北区,菊名六丁目,81,17,6,11
2016/9/30,141097,港北区,菊名六丁目,82,17,3,14
2016/9/30,141097,港北区,菊名六丁目,83,9,3,6
2016/9/30,141097,港北区,菊名六丁目,84,8,1,7
2016/9/30,141097,港北区,菊名六丁目,85,12,3,9
2016/9/30,141097,港北区,菊名六丁目,86,11,2,9
2016/9/30,141097,港北区,菊名六丁目,87,5,0,5
2016/9/30,141097,港北区,菊名六丁目,88,11,4,7
2016/9/30,141097,港北区,菊名六丁目,89,8,3,5
2016/9/30,141097,港北区,菊名六丁目,90,6,2,4
2016/9/30,141097,港北区,菊名六丁目,91,5,0,5
2016/9/30,141097,港北区,菊名六丁目,92,6,1,5
2016/9/30,141097,港北区,菊名六丁目,93,8,1,7
2016/9/30,141097,港北区,菊名六丁目,94,6,0,6
2016/9/30,141097,港北区,菊名六丁目,95,0,0,0
2016/9/30,141097,港北区,菊名六丁目,96,3,2,1
2016/9/30,141097,港北区,菊名六丁目,97,1,1,0
2016/9/30,141097,港北区,菊名六丁目,98,1,0,1
2016/9/30,141097,港北区,菊名六丁目,99,0,0,0
2016/9/30,141097,港北区,菊名六丁目,100,0,0,0
2016/9/30,141097,港北区,菊名七丁目,合計,1390,714,676
2016/9/30,141097,港北区,菊名七丁目,0,6,3,3
2016/9/30,141097,港北区,菊名七丁目,1,7,3,4
2016/9/30,141097,港北区,菊名七丁目,2,7,4,3
2016/9/30,141097,港北区,菊名七丁目,3,9,5,4
2016/9/30,141097,港北区,菊名七丁目,4,6,1,5
2016/9/30,141097,港北区,菊名七丁目,5,8,4,4
2016/9/30,141097,港北区,菊名七丁目,6,13,6,7
2016/9/30,141097,港北区,菊名七丁目,7,3,2,1
2016/9/30,141097,港北区,菊名七丁目,8,7,5,2
2016/9/30,141097,港北区,菊名七丁目,9,8,6,2
2016/9/30,141097,港北区,菊名七丁目,10,6,4,2
2016/9/30,141097,港北区,菊名七丁目,11,9,4,5
2016/9/30,141097,港北区,菊名七丁目,12,4,2,2
2016/9/30,141097,港北区,菊名七丁目,13,8,5,3
2016/9/30,141097,港北区,菊名七丁目,14,8,3,5
2016/9/30,141097,港北区,菊名七丁目,15,8,6,2
2016/9/30,141097,港北区,菊名七丁目,16,6,3,3
2016/9/30,141097,港北区,菊名七丁目,17,8,2,6
2016/9/30,141097,港北区,菊名七丁目,18,11,6,5
2016/9/30,141097,港北区,菊名七丁目,19,16,5,11
2016/9/30,141097,港北区,菊名七丁目,20,16,7,9
2016/9/30,141097,港北区,菊名七丁目,21,13,7,6
2016/9/30,141097,港北区,菊名七丁目,22,21,12,9
2016/9/30,141097,港北区,菊名七丁目,23,36,16,20
2016/9/30,141097,港北区,菊名七丁目,24,31,15,16
2016/9/30,141097,港北区,菊名七丁目,25,27,14,13
2016/9/30,141097,港北区,菊名七丁目,26,26,8,18
2016/9/30,141097,港北区,菊名七丁目,27,26,14,12
2016/9/30,141097,港北区,菊名七丁目,28,32,18,14
2016/9/30,141097,港北区,菊名七丁目,29,23,14,9
2016/9/30,141097,港北区,菊名七丁目,30,31,19,12
2016/9/30,141097,港北区,菊名七丁目,31,24,13,11
2016/9/30,141097,港北区,菊名七丁目,32,26,18,8
2016/9/30,141097,港北区,菊名七丁目,33,19,10,9
2016/9/30,141097,港北区,菊名七丁目,34,28,19,9
2016/9/30,141097,港北区,菊名七丁目,35,21,10,11
2016/9/30,141097,港北区,菊名七丁目,36,29,14,15
2016/9/30,141097,港北区,菊名七丁目,37,28,16,12
2016/9/30,141097,港北区,菊名七丁目,38,22,17,5
2016/9/30,141097,港北区,菊名七丁目,39,17,9,8
2016/9/30,141097,港北区,菊名七丁目,40,12,8,4
2016/9/30,141097,港北区,菊名七丁目,41,28,17,11
2016/9/30,141097,港北区,菊名七丁目,42,20,8,12
2016/9/30,141097,港北区,菊名七丁目,43,23,12,11
2016/9/30,141097,港北区,菊名七丁目,44,26,16,10
2016/9/30,141097,港北区,菊名七丁目,45,15,5,10
2016/9/30,141097,港北区,菊名七丁目,46,24,14,10
2016/9/30,141097,港北区,菊名七丁目,47,20,15,5
2016/9/30,141097,港北区,菊名七丁目,48,24,16,8
2016/9/30,141097,港北区,菊名七丁目,49,18,13,5
2016/9/30,141097,港北区,菊名七丁目,50,23,11,12
2016/9/30,141097,港北区,菊名七丁目,51,26,16,10
2016/9/30,141097,港北区,菊名七丁目,52,20,8,12
2016/9/30,141097,港北区,菊名七丁目,53,18,8,10
2016/9/30,141097,港北区,菊名七丁目,54,23,7,16
2016/9/30,141097,港北区,菊名七丁目,55,15,8,7
2016/9/30,141097,港北区,菊名七丁目,56,27,16,11
2016/9/30,141097,港北区,菊名七丁目,57,20,14,6
2016/9/30,141097,港北区,菊名七丁目,58,20,12,8
2016/9/30,141097,港北区,菊名七丁目,59,18,8,10
2016/9/30,141097,港北区,菊名七丁目,60,14,5,9
2016/9/30,141097,港北区,菊名七丁目,61,18,11,7
2016/9/30,141097,港北区,菊名七丁目,62,11,8,3
2016/9/30,141097,港北区,菊名七丁目,63,5,2,3
2016/9/30,141097,港北区,菊名七丁目,64,16,10,6
2016/9/30,141097,港北区,菊名七丁目,65,13,5,8
2016/9/30,141097,港北区,菊名七丁目,66,8,4,4
2016/9/30,141097,港北区,菊名七丁目,67,16,6,10
2016/9/30,141097,港北区,菊名七丁目,68,21,8,13
2016/9/30,141097,港北区,菊名七丁目,69,13,6,7
2016/9/30,141097,港北区,菊名七丁目,70,14,7,7
2016/9/30,141097,港北区,菊名七丁目,71,8,3,5
2016/9/30,141097,港北区,菊名七丁目,72,9,4,5
2016/9/30,141097,港北区,菊名七丁目,73,6,1,5
2016/9/30,141097,港北区,菊名七丁目,74,11,3,8
2016/9/30,141097,港北区,菊名七丁目,75,11,5,6
2016/9/30,141097,港北区,菊名七丁目,76,11,3,8
2016/9/30,141097,港北区,菊名七丁目,77,6,2,4
2016/9/30,141097,港北区,菊名七丁目,78,11,5,6
2016/9/30,141097,港北区,菊名七丁目,79,8,5,3
2016/9/30,141097,港北区,菊名七丁目,80,12,6,6
2016/9/30,141097,港北区,菊名七丁目,81,6,2,4
2016/9/30,141097,港北区,菊名七丁目,82,8,4,4
2016/9/30,141097,港北区,菊名七丁目,83,8,3,5
2016/9/30,141097,港北区,菊名七丁目,84,5,0,5
2016/9/30,141097,港北区,菊名七丁目,85,10,6,4
2016/9/30,141097,港北区,菊名七丁目,86,11,1,10
2016/9/30,141097,港北区,菊名七丁目,87,4,1,3
2016/9/30,141097,港北区,菊名七丁目,88,7,3,4
2016/9/30,141097,港北区,菊名七丁目,89,3,1,2
2016/9/30,141097,港北区,菊名七丁目,90,4,1,3
2016/9/30,141097,港北区,菊名七丁目,91,2,1,1
2016/9/30,141097,港北区,菊名七丁目,92,3,1,2
2016/9/30,141097,港北区,菊名七丁目,93,1,0,1
2016/9/30,141097,港北区,菊名七丁目,94,0,0,0
2016/9/30,141097,港北区,菊名七丁目,95,0,0,0
2016/9/30,141097,港北区,菊名七丁目,96,1,0,1
2016/9/30,141097,港北区,菊名七丁目,97,1,0,1
2016/9/30,141097,港北区,菊名七丁目,98,0,0,0
2016/9/30,141097,港北区,菊名七丁目,99,0,0,0
2016/9/30,141097,港北区,菊名七丁目,100,0,0,0
2016/9/30,141097,港北区,篠原町,合計,11247,5631,5616
2016/9/30,141097,港北区,篠原町,0,105,51,54
2016/9/30,141097,港北区,篠原町,1,85,48,37
2016/9/30,141097,港北区,篠原町,2,85,49,36
2016/9/30,141097,港北区,篠原町,3,94,43,51
2016/9/30,141097,港北区,篠原町,4,82,47,35
2016/9/30,141097,港北区,篠原町,5,96,52,44
2016/9/30,141097,港北区,篠原町,6,102,60,42
2016/9/30,141097,港北区,篠原町,7,109,62,47
2016/9/30,141097,港北区,篠原町,8,112,69,43
2016/9/30,141097,港北区,篠原町,9,99,54,45
2016/9/30,141097,港北区,篠原町,10,112,51,61
2016/9/30,141097,港北区,篠原町,11,89,45,44
2016/9/30,141097,港北区,篠原町,12,99,54,45
2016/9/30,141097,港北区,篠原町,13,98,52,46
2016/9/30,141097,港北区,篠原町,14,98,44,54
2016/9/30,141097,港北区,篠原町,15,85,44,41
2016/9/30,141097,港北区,篠原町,16,91,38,53
2016/9/30,141097,港北区,篠原町,17,91,52,39
2016/9/30,141097,港北区,篠原町,18,104,50,54
2016/9/30,141097,港北区,篠原町,19,101,55,46
2016/9/30,141097,港北区,篠原町,20,106,53,53
2016/9/30,141097,港北区,篠原町,21,103,56,47
2016/9/30,141097,港北区,篠原町,22,130,73,57
2016/9/30,141097,港北区,篠原町,23,128,64,64
2016/9/30,141097,港北区,篠原町,24,142,69,73
2016/9/30,141097,港北区,篠原町,25,124,68,56
2016/9/30,141097,港北区,篠原町,26,148,85,63
2016/9/30,141097,港北区,篠原町,27,143,67,76
2016/9/30,141097,港北区,篠原町,28,172,87,85
2016/9/30,141097,港北区,篠原町,29,144,78,66
2016/9/30,141097,港北区,篠原町,30,171,86,85
2016/9/30,141097,港北区,篠原町,31,148,70,78
2016/9/30,141097,港北区,篠原町,32,160,94,66
2016/9/30,141097,港北区,篠原町,33,151,80,71
2016/9/30,141097,港北区,篠原町,34,146,74,72
2016/9/30,141097,港北区,篠原町,35,168,95,73
2016/9/30,141097,港北区,篠原町,36,167,84,83
2016/9/30,141097,港北区,篠原町,37,183,108,75
2016/9/30,141097,港北区,篠原町,38,165,85,80
2016/9/30,141097,港北区,篠原町,39,160,84,76
2016/9/30,141097,港北区,篠原町,40,187,94,93
2016/9/30,141097,港北区,篠原町,41,173,73,100
2016/9/30,141097,港北区,篠原町,42,212,109,103
2016/9/30,141097,港北区,篠原町,43,203,104,99
2016/9/30,141097,港北区,篠原町,44,197,95,102
2016/9/30,141097,港北区,篠原町,45,215,102,113
2016/9/30,141097,港北区,篠原町,46,204,96,108
2016/9/30,141097,港北区,篠原町,47,206,105,101
2016/9/30,141097,港北区,篠原町,48,183,99,84
2016/9/30,141097,港北区,篠原町,49,207,109,98
2016/9/30,141097,港北区,篠原町,50,145,87,58
2016/9/30,141097,港北区,篠原町,51,178,90,88
2016/9/30,141097,港北区,篠原町,52,177,88,89
2016/9/30,141097,港北区,篠原町,53,149,77,72
2016/9/30,141097,港北区,篠原町,54,132,68,64
2016/9/30,141097,港北区,篠原町,55,140,67,73
2016/9/30,141097,港北区,篠原町,56,128,60,68
2016/9/30,141097,港北区,篠原町,57,110,63,47
2016/9/30,141097,港北区,篠原町,58,120,65,55
2016/9/30,141097,港北区,篠原町,59,108,50,58
2016/9/30,141097,港北区,篠原町,60,114,55,59
2016/9/30,141097,港北区,篠原町,61,127,70,57
2016/9/30,141097,港北区,篠原町,62,124,60,64
2016/9/30,141097,港北区,篠原町,63,111,52,59
2016/9/30,141097,港北区,篠原町,64,150,71,79
2016/9/30,141097,港北区,篠原町,65,142,72,70
2016/9/30,141097,港北区,篠原町,66,141,67,74
2016/9/30,141097,港北区,篠原町,67,134,64,70
2016/9/30,141097,港北区,篠原町,68,139,71,68
2016/9/30,141097,港北区,篠原町,69,153,77,76
2016/9/30,141097,港北区,篠原町,70,90,51,39
2016/9/30,141097,港北区,篠原町,71,83,40,43
2016/9/30,141097,港北区,篠原町,72,116,50,66
2016/9/30,141097,港北区,篠原町,73,107,55,52
2016/9/30,141097,港北区,篠原町,74,106,43,63
2016/9/30,141097,港北区,篠原町,75,104,54,50
2016/9/30,141097,港北区,篠原町,76,97,38,59
2016/9/30,141097,港北区,篠原町,77,80,40,40
2016/9/30,141097,港北区,篠原町,78,88,43,45
2016/9/30,141097,港北区,篠原町,79,81,32,49
2016/9/30,141097,港北区,篠原町,80,69,28,41
2016/9/30,141097,港北区,篠原町,81,78,37,41
2016/9/30,141097,港北区,篠原町,82,69,18,51
2016/9/30,141097,港北区,篠原町,83,55,24,31
2016/9/30,141097,港北区,篠原町,84,70,28,42
2016/9/30,141097,港北区,篠原町,85,45,21,24
2016/9/30,141097,港北区,篠原町,86,47,17,30
2016/9/30,141097,港北区,篠原町,87,48,14,34
2016/9/30,141097,港北区,篠原町,88,45,17,28
2016/9/30,141097,港北区,篠原町,89,38,14,24
2016/9/30,141097,港北区,篠原町,90,31,9,22
2016/9/30,141097,港北区,篠原町,91,23,7,16
2016/9/30,141097,港北区,篠原町,92,21,3,18
2016/9/30,141097,港北区,篠原町,93,10,2,8
2016/9/30,141097,港北区,篠原町,94,10,2,8
2016/9/30,141097,港北区,篠原町,95,13,3,10
2016/9/30,141097,港北区,篠原町,96,7,0,7
2016/9/30,141097,港北区,篠原町,97,2,1,1
2016/9/30,141097,港北区,篠原町,98,2,0,2
2016/9/30,141097,港北区,篠原町,99,2,0,2
2016/9/30,141097,港北区,篠原町,100,5,0,5
2016/9/30,141097,港北区,篠原東一丁目,合計,1744,830,914
2016/9/30,141097,港北区,篠原東一丁目,0,18,12,6
2016/9/30,141097,港北区,篠原東一丁目,1,21,11,10
2016/9/30,141097,港北区,篠原東一丁目,2,12,6,6
2016/9/30,141097,港北区,篠原東一丁目,3,8,6,2
2016/9/30,141097,港北区,篠原東一丁目,4,22,10,12
2016/9/30,141097,港北区,篠原東一丁目,5,21,12,9
2016/9/30,141097,港北区,篠原東一丁目,6,16,7,9
2016/9/30,141097,港北区,篠原東一丁目,7,23,12,11
2016/9/30,141097,港北区,篠原東一丁目,8,16,13,3
2016/9/30,141097,港北区,篠原東一丁目,9,17,8,9
2016/9/30,141097,港北区,篠原東一丁目,10,15,10,5
2016/9/30,141097,港北区,篠原東一丁目,11,16,8,8
2016/9/30,141097,港北区,篠原東一丁目,12,19,7,12
2016/9/30,141097,港北区,篠原東一丁目,13,7,3,4
2016/9/30,141097,港北区,篠原東一丁目,14,16,10,6
2016/9/30,141097,港北区,篠原東一丁目,15,9,5,4
2016/9/30,141097,港北区,篠原東一丁目,16,15,6,9
2016/9/30,141097,港北区,篠原東一丁目,17,15,6,9
2016/9/30,141097,港北区,篠原東一丁目,18,18,8,10
2016/9/30,141097,港北区,篠原東一丁目,19,16,8,8
2016/9/30,141097,港北区,篠原東一丁目,20,11,8,3
2016/9/30,141097,港北区,篠原東一丁目,21,15,5,10
2016/9/30,141097,港北区,篠原東一丁目,22,20,11,9
2016/9/30,141097,港北区,篠原東一丁目,23,20,10,10
2016/9/30,141097,港北区,篠原東一丁目,24,18,10,8
2016/9/30,141097,港北区,篠原東一丁目,25,19,9,10
2016/9/30,141097,港北区,篠原東一丁目,26,19,9,10
2016/9/30,141097,港北区,篠原東一丁目,27,21,11,10
2016/9/30,141097,港北区,篠原東一丁目,28,26,14,12
2016/9/30,141097,港北区,篠原東一丁目,29,16,7,9
2016/9/30,141097,港北区,篠原東一丁目,30,23,9,14
2016/9/30,141097,港北区,篠原東一丁目,31,29,14,15
2016/9/30,141097,港北区,篠原東一丁目,32,27,8,19
2016/9/30,141097,港北区,篠原東一丁目,33,25,13,12
2016/9/30,141097,港北区,篠原東一丁目,34,25,12,13
2016/9/30,141097,港北区,篠原東一丁目,35,29,14,15
2016/9/30,141097,港北区,篠原東一丁目,36,23,12,11
2016/9/30,141097,港北区,篠原東一丁目,37,31,16,15
2016/9/30,141097,港北区,篠原東一丁目,38,38,16,22
2016/9/30,141097,港北区,篠原東一丁目,39,40,19,21
2016/9/30,141097,港北区,篠原東一丁目,40,28,18,10
2016/9/30,141097,港北区,篠原東一丁目,41,27,12,15
2016/9/30,141097,港北区,篠原東一丁目,42,30,11,19
2016/9/30,141097,港北区,篠原東一丁目,43,38,16,22
2016/9/30,141097,港北区,篠原東一丁目,44,30,14,16
2016/9/30,141097,港北区,篠原東一丁目,45,43,17,26
2016/9/30,141097,港北区,篠原東一丁目,46,31,20,11
2016/9/30,141097,港北区,篠原東一丁目,47,20,9,11
2016/9/30,141097,港北区,篠原東一丁目,48,20,11,9
2016/9/30,141097,港北区,篠原東一丁目,49,28,16,12
2016/9/30,141097,港北区,篠原東一丁目,50,14,8,6
2016/9/30,141097,港北区,篠原東一丁目,51,20,3,17
2016/9/30,141097,港北区,篠原東一丁目,52,29,13,16
2016/9/30,141097,港北区,篠原東一丁目,53,20,11,9
2016/9/30,141097,港北区,篠原東一丁目,54,20,11,9
2016/9/30,141097,港北区,篠原東一丁目,55,18,8,10
2016/9/30,141097,港北区,篠原東一丁目,56,23,14,9
2016/9/30,141097,港北区,篠原東一丁目,57,18,9,9
2016/9/30,141097,港北区,篠原東一丁目,58,28,17,11
2016/9/30,141097,港北区,篠原東一丁目,59,17,7,10
2016/9/30,141097,港北区,篠原東一丁目,60,14,7,7
2016/9/30,141097,港北区,篠原東一丁目,61,17,5,12
2016/9/30,141097,港北区,篠原東一丁目,62,20,11,9
2016/9/30,141097,港北区,篠原東一丁目,63,18,11,7
2016/9/30,141097,港北区,篠原東一丁目,64,25,10,15
2016/9/30,141097,港北区,篠原東一丁目,65,15,4,11
2016/9/30,141097,港北区,篠原東一丁目,66,21,11,10
2016/9/30,141097,港北区,篠原東一丁目,67,14,3,11
2016/9/30,141097,港北区,篠原東一丁目,68,29,15,14
2016/9/30,141097,港北区,篠原東一丁目,69,25,9,16
2016/9/30,141097,港北区,篠原東一丁目,70,13,4,9
2016/9/30,141097,港北区,篠原東一丁目,71,19,12,7
2016/9/30,141097,港北区,篠原東一丁目,72,16,5,11
2016/9/30,141097,港北区,篠原東一丁目,73,15,7,8
2016/9/30,141097,港北区,篠原東一丁目,74,15,6,9
2016/9/30,141097,港北区,篠原東一丁目,75,15,7,8
2016/9/30,141097,港北区,篠原東一丁目,76,16,6,10
2016/9/30,141097,港北区,篠原東一丁目,77,7,3,4
2016/9/30,141097,港北区,篠原東一丁目,78,13,8,5
2016/9/30,141097,港北区,篠原東一丁目,79,11,4,7
2016/9/30,141097,港北区,篠原東一丁目,80,8,2,6
2016/9/30,141097,港北区,篠原東一丁目,81,7,4,3
2016/9/30,141097,港北区,篠原東一丁目,82,6,4,2
2016/9/30,141097,港北区,篠原東一丁目,83,14,3,11
2016/9/30,141097,港北区,篠原東一丁目,84,14,4,10
2016/9/30,141097,港北区,篠原東一丁目,85,12,5,7
2016/9/30,141097,港北区,篠原東一丁目,86,9,1,8
2016/9/30,141097,港北区,篠原東一丁目,87,7,1,6
2016/9/30,141097,港北区,篠原東一丁目,88,9,4,5
2016/9/30,141097,港北区,篠原東一丁目,89,8,3,5
2016/9/30,141097,港北区,篠原東一丁目,90,4,3,1
2016/9/30,141097,港北区,篠原東一丁目,91,3,3,0
2016/9/30,141097,港北区,篠原東一丁目,92,3,1,2
2016/9/30,141097,港北区,篠原東一丁目,93,1,1,0
2016/9/30,141097,港北区,篠原東一丁目,94,0,0,0
2016/9/30,141097,港北区,篠原東一丁目,95,1,1,0
2016/9/30,141097,港北区,篠原東一丁目,96,0,0,0
2016/9/30,141097,港北区,篠原東一丁目,97,2,2,0
2016/9/30,141097,港北区,篠原東一丁目,98,1,0,1
2016/9/30,141097,港北区,篠原東一丁目,99,0,0,0
2016/9/30,141097,港北区,篠原東一丁目,100,0,0,0
2016/9/30,141097,港北区,篠原東二丁目,合計,1584,777,807
2016/9/30,141097,港北区,篠原東二丁目,0,10,3,7
2016/9/30,141097,港北区,篠原東二丁目,1,21,12,9
2016/9/30,141097,港北区,篠原東二丁目,2,17,12,5
2016/9/30,141097,港北区,篠原東二丁目,3,15,10,5
2016/9/30,141097,港北区,篠原東二丁目,4,18,14,4
2016/9/30,141097,港北区,篠原東二丁目,5,15,8,7
2016/9/30,141097,港北区,篠原東二丁目,6,10,7,3
2016/9/30,141097,港北区,篠原東二丁目,7,10,6,4
2016/9/30,141097,港北区,篠原東二丁目,8,12,10,2
2016/9/30,141097,港北区,篠原東二丁目,9,13,8,5
2016/9/30,141097,港北区,篠原東二丁目,10,9,3,6
2016/9/30,141097,港北区,篠原東二丁目,11,11,3,8
2016/9/30,141097,港北区,篠原東二丁目,12,12,6,6
2016/9/30,141097,港北区,篠原東二丁目,13,14,9,5
2016/9/30,141097,港北区,篠原東二丁目,14,12,6,6
2016/9/30,141097,港北区,篠原東二丁目,15,14,7,7
2016/9/30,141097,港北区,篠原東二丁目,16,10,2,8
2016/9/30,141097,港北区,篠原東二丁目,17,13,4,9
2016/9/30,141097,港北区,篠原東二丁目,18,11,5,6
2016/9/30,141097,港北区,篠原東二丁目,19,12,7,5
2016/9/30,141097,港北区,篠原東二丁目,20,13,3,10
2016/9/30,141097,港北区,篠原東二丁目,21,17,11,6
2016/9/30,141097,港北区,篠原東二丁目,22,11,7,4
2016/9/30,141097,港北区,篠原東二丁目,23,17,10,7
2016/9/30,141097,港北区,篠原東二丁目,24,21,9,12
2016/9/30,141097,港北区,篠原東二丁目,25,12,8,4
2016/9/30,141097,港北区,篠原東二丁目,26,14,6,8
2016/9/30,141097,港北区,篠原東二丁目,27,20,9,11
2016/9/30,141097,港北区,篠原東二丁目,28,17,8,9
2016/9/30,141097,港北区,篠原東二丁目,29,20,8,12
2016/9/30,141097,港北区,篠原東二丁目,30,23,12,11
2016/9/30,141097,港北区,篠原東二丁目,31,23,11,12
2016/9/30,141097,港北区,篠原東二丁目,32,23,11,12
2016/9/30,141097,港北区,篠原東二丁目,33,33,14,19
2016/9/30,141097,港北区,篠原東二丁目,34,23,14,9
2016/9/30,141097,港北区,篠原東二丁目,35,14,6,8
2016/9/30,141097,港北区,篠原東二丁目,36,27,11,16
2016/9/30,141097,港北区,篠原東二丁目,37,23,14,9
2016/9/30,141097,港北区,篠原東二丁目,38,25,15,10
2016/9/30,141097,港北区,篠原東二丁目,39,23,11,12
2016/9/30,141097,港北区,篠原東二丁目,40,28,17,11
2016/9/30,141097,港北区,篠原東二丁目,41,35,18,17
2016/9/30,141097,港北区,篠原東二丁目,42,28,14,14
2016/9/30,141097,港北区,篠原東二丁目,43,15,8,7
2016/9/30,141097,港北区,篠原東二丁目,44,22,11,11
2016/9/30,141097,港北区,篠原東二丁目,45,19,10,9
2016/9/30,141097,港北区,篠原東二丁目,46,25,14,11
2016/9/30,141097,港北区,篠原東二丁目,47,28,16,12
2016/9/30,141097,港北区,篠原東二丁目,48,29,11,18
2016/9/30,141097,港北区,篠原東二丁目,49,22,11,11
2016/9/30,141097,港北区,篠原東二丁目,50,21,13,8
2016/9/30,141097,港北区,篠原東二丁目,51,42,17,25
2016/9/30,141097,港北区,篠原東二丁目,52,20,8,12
2016/9/30,141097,港北区,篠原東二丁目,53,24,15,9
2016/9/30,141097,港北区,篠原東二丁目,54,19,10,9
2016/9/30,141097,港北区,篠原東二丁目,55,15,9,6
2016/9/30,141097,港北区,篠原東二丁目,56,20,9,11
2016/9/30,141097,港北区,篠原東二丁目,57,18,7,11
2016/9/30,141097,港北区,篠原東二丁目,58,11,5,6
2016/9/30,141097,港北区,篠原東二丁目,59,20,13,7
2016/9/30,141097,港北区,篠原東二丁目,60,26,15,11
2016/9/30,141097,港北区,篠原東二丁目,61,15,8,7
2016/9/30,141097,港北区,篠原東二丁目,62,13,9,4
2016/9/30,141097,港北区,篠原東二丁目,63,19,9,10
2016/9/30,141097,港北区,篠原東二丁目,64,19,9,10
2016/9/30,141097,港北区,篠原東二丁目,65,17,6,11
2016/9/30,141097,港北区,篠原東二丁目,66,20,10,10
2016/9/30,141097,港北区,篠原東二丁目,67,30,8,22
2016/9/30,141097,港北区,篠原東二丁目,68,20,9,11
2016/9/30,141097,港北区,篠原東二丁目,69,23,11,12
2016/9/30,141097,港北区,篠原東二丁目,70,21,11,10
2016/9/30,141097,港北区,篠原東二丁目,71,12,6,6
2016/9/30,141097,港北区,篠原東二丁目,72,10,2,8
2016/9/30,141097,港北区,篠原東二丁目,73,19,8,11
2016/9/30,141097,港北区,篠原東二丁目,74,21,7,14
2016/9/30,141097,港北区,篠原東二丁目,75,20,10,10
2016/9/30,141097,港北区,篠原東二丁目,76,17,7,10
2016/9/30,141097,港北区,篠原東二丁目,77,12,8,4
2016/9/30,141097,港北区,篠原東二丁目,78,12,11,1
2016/9/30,141097,港北区,篠原東二丁目,79,9,4,5
2016/9/30,141097,港北区,篠原東二丁目,80,12,5,7
2016/9/30,141097,港北区,篠原東二丁目,81,10,3,7
2016/9/30,141097,港北区,篠原東二丁目,82,8,3,5
2016/9/30,141097,港北区,篠原東二丁目,83,8,1,7
2016/9/30,141097,港北区,篠原東二丁目,84,7,2,5
2016/9/30,141097,港北区,篠原東二丁目,85,10,3,7
2016/9/30,141097,港北区,篠原東二丁目,86,2,1,1
2016/9/30,141097,港北区,篠原東二丁目,87,4,0,4
2016/9/30,141097,港北区,篠原東二丁目,88,3,1,2
2016/9/30,141097,港北区,篠原東二丁目,89,8,5,3
2016/9/30,141097,港北区,篠原東二丁目,90,12,5,7
2016/9/30,141097,港北区,篠原東二丁目,91,7,1,6
2016/9/30,141097,港北区,篠原東二丁目,92,3,1,2
2016/9/30,141097,港北区,篠原東二丁目,93,4,1,3
2016/9/30,141097,港北区,篠原東二丁目,94,2,0,2
2016/9/30,141097,港北区,篠原東二丁目,95,2,1,1
2016/9/30,141097,港北区,篠原東二丁目,96,4,0,4
2016/9/30,141097,港北区,篠原東二丁目,97,2,0,2
2016/9/30,141097,港北区,篠原東二丁目,98,0,0,0
2016/9/30,141097,港北区,篠原東二丁目,99,0,0,0
2016/9/30,141097,港北区,篠原東二丁目,100,2,0,2
2016/9/30,141097,港北区,篠原東三丁目,合計,2051,992,1059
2016/9/30,141097,港北区,篠原東三丁目,0,18,6,12
2016/9/30,141097,港北区,篠原東三丁目,1,15,10,5
2016/9/30,141097,港北区,篠原東三丁目,2,22,13,9
2016/9/30,141097,港北区,篠原東三丁目,3,10,7,3
2016/9/30,141097,港北区,篠原東三丁目,4,13,4,9
2016/9/30,141097,港北区,篠原東三丁目,5,16,7,9
2016/9/30,141097,港北区,篠原東三丁目,6,12,6,6
2016/9/30,141097,港北区,篠原東三丁目,7,10,3,7
2016/9/30,141097,港北区,篠原東三丁目,8,16,6,10
2016/9/30,141097,港北区,篠原東三丁目,9,18,13,5
2016/9/30,141097,港北区,篠原東三丁目,10,14,7,7
2016/9/30,141097,港北区,篠原東三丁目,11,16,8,8
2016/9/30,141097,港北区,篠原東三丁目,12,21,9,12
2016/9/30,141097,港北区,篠原東三丁目,13,14,8,6
2016/9/30,141097,港北区,篠原東三丁目,14,19,7,12
2016/9/30,141097,港北区,篠原東三丁目,15,14,7,7
2016/9/30,141097,港北区,篠原東三丁目,16,22,14,8
2016/9/30,141097,港北区,篠原東三丁目,17,26,16,10
2016/9/30,141097,港北区,篠原東三丁目,18,21,7,14
2016/9/30,141097,港北区,篠原東三丁目,19,16,7,9
2016/9/30,141097,港北区,篠原東三丁目,20,22,12,10
2016/9/30,141097,港北区,篠原東三丁目,21,20,9,11
2016/9/30,141097,港北区,篠原東三丁目,22,22,7,15
2016/9/30,141097,港北区,篠原東三丁目,23,32,21,11
2016/9/30,141097,港北区,篠原東三丁目,24,25,9,16
2016/9/30,141097,港北区,篠原東三丁目,25,20,7,13
2016/9/30,141097,港北区,篠原東三丁目,26,23,12,11
2016/9/30,141097,港北区,篠原東三丁目,27,29,17,12
2016/9/30,141097,港北区,篠原東三丁目,28,40,17,23
2016/9/30,141097,港北区,篠原東三丁目,29,31,20,11
2016/9/30,141097,港北区,篠原東三丁目,30,35,13,22
2016/9/30,141097,港北区,篠原東三丁目,31,33,17,16
2016/9/30,141097,港北区,篠原東三丁目,32,31,18,13
2016/9/30,141097,港北区,篠原東三丁目,33,28,15,13
2016/9/30,141097,港北区,篠原東三丁目,34,28,14,14
2016/9/30,141097,港北区,篠原東三丁目,35,29,16,13
2016/9/30,141097,港北区,篠原東三丁目,36,32,12,20
2016/9/30,141097,港北区,篠原東三丁目,37,27,16,11
2016/9/30,141097,港北区,篠原東三丁目,38,20,9,11
2016/9/30,141097,港北区,篠原東三丁目,39,28,14,14
2016/9/30,141097,港北区,篠原東三丁目,40,31,16,15
2016/9/30,141097,港北区,篠原東三丁目,41,34,20,14
2016/9/30,141097,港北区,篠原東三丁目,42,33,22,11
2016/9/30,141097,港北区,篠原東三丁目,43,39,18,21
2016/9/30,141097,港北区,篠原東三丁目,44,37,23,14
2016/9/30,141097,港北区,篠原東三丁目,45,41,22,19
2016/9/30,141097,港北区,篠原東三丁目,46,30,14,16
2016/9/30,141097,港北区,篠原東三丁目,47,40,16,24
2016/9/30,141097,港北区,篠原東三丁目,48,30,15,15
2016/9/30,141097,港北区,篠原東三丁目,49,43,19,24
2016/9/30,141097,港北区,篠原東三丁目,50,24,10,14
2016/9/30,141097,港北区,篠原東三丁目,51,30,18,12
2016/9/30,141097,港北区,篠原東三丁目,52,30,13,17
2016/9/30,141097,港北区,篠原東三丁目,53,29,14,15
2016/9/30,141097,港北区,篠原東三丁目,54,27,14,13
2016/9/30,141097,港北区,篠原東三丁目,55,32,16,16
2016/9/30,141097,港北区,篠原東三丁目,56,34,15,19
2016/9/30,141097,港北区,篠原東三丁目,57,20,10,10
2016/9/30,141097,港北区,篠原東三丁目,58,27,17,10
2016/9/30,141097,港北区,篠原東三丁目,59,24,14,10
2016/9/30,141097,港北区,篠原東三丁目,60,22,11,11
2016/9/30,141097,港北区,篠原東三丁目,61,24,9,15
2016/9/30,141097,港北区,篠原東三丁目,62,17,10,7
2016/9/30,141097,港北区,篠原東三丁目,63,16,9,7
2016/9/30,141097,港北区,篠原東三丁目,64,21,10,11
2016/9/30,141097,港北区,篠原東三丁目,65,15,7,8
2016/9/30,141097,港北区,篠原東三丁目,66,23,9,14
2016/9/30,141097,港北区,篠原東三丁目,67,23,13,10
2016/9/30,141097,港北区,篠原東三丁目,68,32,19,13
2016/9/30,141097,港北区,篠原東三丁目,69,16,6,10
2016/9/30,141097,港北区,篠原東三丁目,70,21,8,13
2016/9/30,141097,港北区,篠原東三丁目,71,29,15,14
2016/9/30,141097,港北区,篠原東三丁目,72,18,7,11
2016/9/30,141097,港北区,篠原東三丁目,73,20,6,14
2016/9/30,141097,港北区,篠原東三丁目,74,21,9,12
2016/9/30,141097,港北区,篠原東三丁目,75,22,12,10
2016/9/30,141097,港北区,篠原東三丁目,76,10,5,5
2016/9/30,141097,港北区,篠原東三丁目,77,16,7,9
2016/9/30,141097,港北区,篠原東三丁目,78,11,5,6
2016/9/30,141097,港北区,篠原東三丁目,79,12,7,5
2016/9/30,141097,港北区,篠原東三丁目,80,12,4,8
2016/9/30,141097,港北区,篠原東三丁目,81,11,2,9
2016/9/30,141097,港北区,篠原東三丁目,82,13,2,11
2016/9/30,141097,港北区,篠原東三丁目,83,12,4,8
2016/9/30,141097,港北区,篠原東三丁目,84,13,4,9
2016/9/30,141097,港北区,篠原東三丁目,85,12,7,5
2016/9/30,141097,港北区,篠原東三丁目,86,18,7,11
2016/9/30,141097,港北区,篠原東三丁目,87,8,4,4
2016/9/30,141097,港北区,篠原東三丁目,88,7,1,6
2016/9/30,141097,港北区,篠原東三丁目,89,11,2,9
2016/9/30,141097,港北区,篠原東三丁目,90,6,2,4
2016/9/30,141097,港北区,篠原東三丁目,91,4,2,2
2016/9/30,141097,港北区,篠原東三丁目,92,2,1,1
2016/9/30,141097,港北区,篠原東三丁目,93,1,0,1
2016/9/30,141097,港北区,篠原東三丁目,94,3,0,3
2016/9/30,141097,港北区,篠原東三丁目,95,3,0,3
2016/9/30,141097,港北区,篠原東三丁目,96,0,0,0
2016/9/30,141097,港北区,篠原東三丁目,97,0,0,0
2016/9/30,141097,港北区,篠原東三丁目,98,1,0,1
2016/9/30,141097,港北区,篠原東三丁目,99,1,0,1
2016/9/30,141097,港北区,篠原東三丁目,100,1,0,1
2016/9/30,141097,港北区,富士塚一丁目,合計,1950,945,1005
2016/9/30,141097,港北区,富士塚一丁目,0,7,4,3
2016/9/30,141097,港北区,富士塚一丁目,1,12,7,5
2016/9/30,141097,港北区,富士塚一丁目,2,11,3,8
2016/9/30,141097,港北区,富士塚一丁目,3,4,2,2
2016/9/30,141097,港北区,富士塚一丁目,4,14,6,8
2016/9/30,141097,港北区,富士塚一丁目,5,17,7,10
2016/9/30,141097,港北区,富士塚一丁目,6,21,9,12
2016/9/30,141097,港北区,富士塚一丁目,7,14,5,9
2016/9/30,141097,港北区,富士塚一丁目,8,13,6,7
2016/9/30,141097,港北区,富士塚一丁目,9,16,10,6
2016/9/30,141097,港北区,富士塚一丁目,10,12,6,6
2016/9/30,141097,港北区,富士塚一丁目,11,21,10,11
2016/9/30,141097,港北区,富士塚一丁目,12,21,11,10
2016/9/30,141097,港北区,富士塚一丁目,13,19,10,9
2016/9/30,141097,港北区,富士塚一丁目,14,13,9,4
2016/9/30,141097,港北区,富士塚一丁目,15,21,11,10
2016/9/30,141097,港北区,富士塚一丁目,16,11,6,5
2016/9/30,141097,港北区,富士塚一丁目,17,18,11,7
2016/9/30,141097,港北区,富士塚一丁目,18,21,16,5
2016/9/30,141097,港北区,富士塚一丁目,19,23,9,14
2016/9/30,141097,港北区,富士塚一丁目,20,14,11,3
2016/9/30,141097,港北区,富士塚一丁目,21,20,12,8
2016/9/30,141097,港北区,富士塚一丁目,22,33,20,13
2016/9/30,141097,港北区,富士塚一丁目,23,25,13,12
2016/9/30,141097,港北区,富士塚一丁目,24,23,12,11
2016/9/30,141097,港北区,富士塚一丁目,25,17,6,11
2016/9/30,141097,港北区,富士塚一丁目,26,19,13,6
2016/9/30,141097,港北区,富士塚一丁目,27,22,10,12
2016/9/30,141097,港北区,富士塚一丁目,28,29,13,16
2016/9/30,141097,港北区,富士塚一丁目,29,25,13,12
2016/9/30,141097,港北区,富士塚一丁目,30,24,10,14
2016/9/30,141097,港北区,富士塚一丁目,31,28,14,14
2016/9/30,141097,港北区,富士塚一丁目,32,20,12,8
2016/9/30,141097,港北区,富士塚一丁目,33,18,10,8
2016/9/30,141097,港北区,富士塚一丁目,34,26,13,13
2016/9/30,141097,港北区,富士塚一丁目,35,24,14,10
2016/9/30,141097,港北区,富士塚一丁目,36,22,14,8
2016/9/30,141097,港北区,富士塚一丁目,37,19,9,10
2016/9/30,141097,港北区,富士塚一丁目,38,15,9,6
2016/9/30,141097,港北区,富士塚一丁目,39,20,11,9
2016/9/30,141097,港北区,富士塚一丁目,40,24,6,18
2016/9/30,141097,港北区,富士塚一丁目,41,23,14,9
2016/9/30,141097,港北区,富士塚一丁目,42,31,19,12
2016/9/30,141097,港北区,富士塚一丁目,43,22,9,13
2016/9/30,141097,港北区,富士塚一丁目,44,25,12,13
2016/9/30,141097,港北区,富士塚一丁目,45,40,18,22
2016/9/30,141097,港北区,富士塚一丁目,46,34,20,14
2016/9/30,141097,港北区,富士塚一丁目,47,32,15,17
2016/9/30,141097,港北区,富士塚一丁目,48,30,14,16
2016/9/30,141097,港北区,富士塚一丁目,49,33,19,14
2016/9/30,141097,港北区,富士塚一丁目,50,25,9,16
2016/9/30,141097,港北区,富士塚一丁目,51,25,7,18
2016/9/30,141097,港北区,富士塚一丁目,52,19,10,9
2016/9/30,141097,港北区,富士塚一丁目,53,35,18,17
2016/9/30,141097,港北区,富士塚一丁目,54,35,17,18
2016/9/30,141097,港北区,富士塚一丁目,55,38,21,17
2016/9/30,141097,港北区,富士塚一丁目,56,33,16,17
2016/9/30,141097,港北区,富士塚一丁目,57,34,18,16
2016/9/30,141097,港北区,富士塚一丁目,58,39,22,17
2016/9/30,141097,港北区,富士塚一丁目,59,27,11,16
2016/9/30,141097,港北区,富士塚一丁目,60,32,12,20
2016/9/30,141097,港北区,富士塚一丁目,61,25,15,10
2016/9/30,141097,港北区,富士塚一丁目,62,14,10,4
2016/9/30,141097,港北区,富士塚一丁目,63,21,10,11
2016/9/30,141097,港北区,富士塚一丁目,64,23,9,14
2016/9/30,141097,港北区,富士塚一丁目,65,26,12,14
2016/9/30,141097,港北区,富士塚一丁目,66,21,14,7
2016/9/30,141097,港北区,富士塚一丁目,67,28,10,18
2016/9/30,141097,港北区,富士塚一丁目,68,34,14,20
2016/9/30,141097,港北区,富士塚一丁目,69,30,15,15
2016/9/30,141097,港北区,富士塚一丁目,70,22,11,11
2016/9/30,141097,港北区,富士塚一丁目,71,18,7,11
2016/9/30,141097,港北区,富士塚一丁目,72,20,12,8
2016/9/30,141097,港北区,富士塚一丁目,73,16,6,10
2016/9/30,141097,港北区,富士塚一丁目,74,14,6,8
2016/9/30,141097,港北区,富士塚一丁目,75,20,7,13
2016/9/30,141097,港北区,富士塚一丁目,76,17,10,7
2016/9/30,141097,港北区,富士塚一丁目,77,21,12,9
2016/9/30,141097,港北区,富士塚一丁目,78,25,10,15
2016/9/30,141097,港北区,富士塚一丁目,79,14,5,9
2016/9/30,141097,港北区,富士塚一丁目,80,16,5,11
2016/9/30,141097,港北区,富士塚一丁目,81,16,6,10
2016/9/30,141097,港北区,富士塚一丁目,82,18,6,12
2016/9/30,141097,港北区,富士塚一丁目,83,12,4,8
2016/9/30,141097,港北区,富士塚一丁目,84,7,1,6
2016/9/30,141097,港北区,富士塚一丁目,85,18,7,11
2016/9/30,141097,港北区,富士塚一丁目,86,11,6,5
2016/9/30,141097,港北区,富士塚一丁目,87,11,2,9
2016/9/30,141097,港北区,富士塚一丁目,88,9,4,5
2016/9/30,141097,港北区,富士塚一丁目,89,5,0,5
2016/9/30,141097,港北区,富士塚一丁目,90,6,2,4
2016/9/30,141097,港北区,富士塚一丁目,91,4,0,4
2016/9/30,141097,港北区,富士塚一丁目,92,8,1,7
2016/9/30,141097,港北区,富士塚一丁目,93,1,0,1
2016/9/30,141097,港北区,富士塚一丁目,94,3,1,2
2016/9/30,141097,港北区,富士塚一丁目,95,5,1,4
2016/9/30,141097,港北区,富士塚一丁目,96,1,0,1
2016/9/30,141097,港北区,富士塚一丁目,97,1,0,1
2016/9/30,141097,港北区,富士塚一丁目,98,0,0,0
2016/9/30,141097,港北区,富士塚一丁目,99,0,0,0
2016/9/30,141097,港北区,富士塚一丁目,100,1,0,1
2016/9/30,141097,港北区,富士塚二丁目,合計,2907,1429,1478
2016/9/30,141097,港北区,富士塚二丁目,0,21,12,9
2016/9/30,141097,港北区,富士塚二丁目,1,21,10,11
2016/9/30,141097,港北区,富士塚二丁目,2,24,11,13
2016/9/30,141097,港北区,富士塚二丁目,3,18,13,5
2016/9/30,141097,港北区,富士塚二丁目,4,15,6,9
2016/9/30,141097,港北区,富士塚二丁目,5,17,12,5
2016/9/30,141097,港北区,富士塚二丁目,6,26,12,14
2016/9/30,141097,港北区,富士塚二丁目,7,19,9,10
2016/9/30,141097,港北区,富士塚二丁目,8,20,5,15
2016/9/30,141097,港北区,富士塚二丁目,9,20,7,13
2016/9/30,141097,港北区,富士塚二丁目,10,22,12,10
2016/9/30,141097,港北区,富士塚二丁目,11,20,13,7
2016/9/30,141097,港北区,富士塚二丁目,12,19,10,9
2016/9/30,141097,港北区,富士塚二丁目,13,22,11,11
2016/9/30,141097,港北区,富士塚二丁目,14,24,13,11
2016/9/30,141097,港北区,富士塚二丁目,15,22,14,8
2016/9/30,141097,港北区,富士塚二丁目,16,34,16,18
2016/9/30,141097,港北区,富士塚二丁目,17,34,15,19
2016/9/30,141097,港北区,富士塚二丁目,18,19,11,8
2016/9/30,141097,港北区,富士塚二丁目,19,32,18,14
2016/9/30,141097,港北区,富士塚二丁目,20,29,15,14
2016/9/30,141097,港北区,富士塚二丁目,21,33,18,15
2016/9/30,141097,港北区,富士塚二丁目,22,34,16,18
2016/9/30,141097,港北区,富士塚二丁目,23,31,17,14
2016/9/30,141097,港北区,富士塚二丁目,24,42,22,20
2016/9/30,141097,港北区,富士塚二丁目,25,41,18,23
2016/9/30,141097,港北区,富士塚二丁目,26,54,26,28
2016/9/30,141097,港北区,富士塚二丁目,27,52,25,27
2016/9/30,141097,港北区,富士塚二丁目,28,44,22,22
2016/9/30,141097,港北区,富士塚二丁目,29,43,21,22
2016/9/30,141097,港北区,富士塚二丁目,30,35,22,13
2016/9/30,141097,港北区,富士塚二丁目,31,40,22,18
2016/9/30,141097,港北区,富士塚二丁目,32,40,25,15
2016/9/30,141097,港北区,富士塚二丁目,33,39,22,17
2016/9/30,141097,港北区,富士塚二丁目,34,47,25,22
2016/9/30,141097,港北区,富士塚二丁目,35,27,12,15
2016/9/30,141097,港北区,富士塚二丁目,36,40,14,26
2016/9/30,141097,港北区,富士塚二丁目,37,35,18,17
2016/9/30,141097,港北区,富士塚二丁目,38,33,17,16
2016/9/30,141097,港北区,富士塚二丁目,39,41,20,21
2016/9/30,141097,港北区,富士塚二丁目,40,38,24,14
2016/9/30,141097,港北区,富士塚二丁目,41,43,20,23
2016/9/30,141097,港北区,富士塚二丁目,42,43,24,19
2016/9/30,141097,港北区,富士塚二丁目,43,29,15,14
2016/9/30,141097,港北区,富士塚二丁目,44,40,16,24
2016/9/30,141097,港北区,富士塚二丁目,45,37,24,13
2016/9/30,141097,港北区,富士塚二丁目,46,33,15,18
2016/9/30,141097,港北区,富士塚二丁目,47,40,19,21
2016/9/30,141097,港北区,富士塚二丁目,48,53,24,29
2016/9/30,141097,港北区,富士塚二丁目,49,51,25,26
2016/9/30,141097,港北区,富士塚二丁目,50,61,31,30
2016/9/30,141097,港北区,富士塚二丁目,51,54,31,23
2016/9/30,141097,港北区,富士塚二丁目,52,53,16,37
2016/9/30,141097,港北区,富士塚二丁目,53,61,38,23
2016/9/30,141097,港北区,富士塚二丁目,54,46,23,23
2016/9/30,141097,港北区,富士塚二丁目,55,44,24,20
2016/9/30,141097,港北区,富士塚二丁目,56,36,21,15
2016/9/30,141097,港北区,富士塚二丁目,57,36,20,16
2016/9/30,141097,港北区,富士塚二丁目,58,40,17,23
2016/9/30,141097,港北区,富士塚二丁目,59,33,16,17
2016/9/30,141097,港北区,富士塚二丁目,60,28,14,14
2016/9/30,141097,港北区,富士塚二丁目,61,43,16,27
2016/9/30,141097,港北区,富士塚二丁目,62,38,13,25
2016/9/30,141097,港北区,富士塚二丁目,63,37,23,14
2016/9/30,141097,港北区,富士塚二丁目,64,42,14,28
2016/9/30,141097,港北区,富士塚二丁目,65,34,17,17
2016/9/30,141097,港北区,富士塚二丁目,66,26,13,13
2016/9/30,141097,港北区,富士塚二丁目,67,50,29,21
2016/9/30,141097,港北区,富士塚二丁目,68,63,28,35
2016/9/30,141097,港北区,富士塚二丁目,69,39,25,14
2016/9/30,141097,港北区,富士塚二丁目,70,15,8,7
2016/9/30,141097,港北区,富士塚二丁目,71,19,11,8
2016/9/30,141097,港北区,富士塚二丁目,72,22,9,13
2016/9/30,141097,港北区,富士塚二丁目,73,20,13,7
2016/9/30,141097,港北区,富士塚二丁目,74,23,11,12
2016/9/30,141097,港北区,富士塚二丁目,75,17,12,5
2016/9/30,141097,港北区,富士塚二丁目,76,26,11,15
2016/9/30,141097,港北区,富士塚二丁目,77,17,5,12
2016/9/30,141097,港北区,富士塚二丁目,78,21,6,15
2016/9/30,141097,港北区,富士塚二丁目,79,18,10,8
2016/9/30,141097,港北区,富士塚二丁目,80,24,7,17
2016/9/30,141097,港北区,富士塚二丁目,81,15,6,9
2016/9/30,141097,港北区,富士塚二丁目,82,12,5,7
2016/9/30,141097,港北区,富士塚二丁目,83,17,9,8
2016/9/30,141097,港北区,富士塚二丁目,84,14,6,8
2016/9/30,141097,港北区,富士塚二丁目,85,15,8,7
2016/9/30,141097,港北区,富士塚二丁目,86,17,5,12
2016/9/30,141097,港北区,富士塚二丁目,87,18,4,14
2016/9/30,141097,港北区,富士塚二丁目,88,13,4,9
2016/9/30,141097,港北区,富士塚二丁目,89,13,5,8
2016/9/30,141097,港北区,富士塚二丁目,90,18,5,13
2016/9/30,141097,港北区,富士塚二丁目,91,8,1,7
2016/9/30,141097,港北区,富士塚二丁目,92,5,1,4
2016/9/30,141097,港北区,富士塚二丁目,93,2,1,1
2016/9/30,141097,港北区,富士塚二丁目,94,6,1,5
2016/9/30,141097,港北区,富士塚二丁目,95,7,2,5
2016/9/30,141097,港北区,富士塚二丁目,96,1,0,1
2016/9/30,141097,港北区,富士塚二丁目,97,0,0,0
2016/9/30,141097,港北区,富士塚二丁目,98,1,1,0
2016/9/30,141097,港北区,富士塚二丁目,99,2,0,2
2016/9/30,141097,港北区,富士塚二丁目,100,1,0,1
2016/9/30,141097,港北区,錦が丘,合計,1885,916,969
2016/9/30,141097,港北区,錦が丘,0,10,5,5
2016/9/30,141097,港北区,錦が丘,1,11,6,5
2016/9/30,141097,港北区,錦が丘,2,8,5,3
2016/9/30,141097,港北区,錦が丘,3,9,3,6
2016/9/30,141097,港北区,錦が丘,4,3,0,3
2016/9/30,141097,港北区,錦が丘,5,10,5,5
2016/9/30,141097,港北区,錦が丘,6,11,5,6
2016/9/30,141097,港北区,錦が丘,7,5,4,1
2016/9/30,141097,港北区,錦が丘,8,10,5,5
2016/9/30,141097,港北区,錦が丘,9,11,8,3
2016/9/30,141097,港北区,錦が丘,10,6,1,5
2016/9/30,141097,港北区,錦が丘,11,7,2,5
2016/9/30,141097,港北区,錦が丘,12,9,7,2
2016/9/30,141097,港北区,錦が丘,13,9,4,5
2016/9/30,141097,港北区,錦が丘,14,8,4,4
2016/9/30,141097,港北区,錦が丘,15,8,4,4
2016/9/30,141097,港北区,錦が丘,16,9,2,7
2016/9/30,141097,港北区,錦が丘,17,11,3,8
2016/9/30,141097,港北区,錦が丘,18,14,8,6
2016/9/30,141097,港北区,錦が丘,19,12,5,7
2016/9/30,141097,港北区,錦が丘,20,24,14,10
2016/9/30,141097,港北区,錦が丘,21,21,8,13
2016/9/30,141097,港北区,錦が丘,22,30,12,18
2016/9/30,141097,港北区,錦が丘,23,32,13,19
2016/9/30,141097,港北区,錦が丘,24,33,21,12
2016/9/30,141097,港北区,錦が丘,25,52,25,27
2016/9/30,141097,港北区,錦が丘,26,44,21,23
2016/9/30,141097,港北区,錦が丘,27,51,31,20
2016/9/30,141097,港北区,錦が丘,28,49,19,30
2016/9/30,141097,港北区,錦が丘,29,43,20,23
2016/9/30,141097,港北区,錦が丘,30,49,22,27
2016/9/30,141097,港北区,錦が丘,31,36,19,17
2016/9/30,141097,港北区,錦が丘,32,30,12,18
2016/9/30,141097,港北区,錦が丘,33,27,20,7
2016/9/30,141097,港北区,錦が丘,34,42,24,18
2016/9/30,141097,港北区,錦が丘,35,36,17,19
2016/9/30,141097,港北区,錦が丘,36,21,10,11
2016/9/30,141097,港北区,錦が丘,37,24,12,12
2016/9/30,141097,港北区,錦が丘,38,23,11,12
2016/9/30,141097,港北区,錦が丘,39,30,17,13
2016/9/30,141097,港北区,錦が丘,40,21,10,11
2016/9/30,141097,港北区,錦が丘,41,29,22,7
2016/9/30,141097,港北区,錦が丘,42,29,19,10
2016/9/30,141097,港北区,錦が丘,43,31,11,20
2016/9/30,141097,港北区,錦が丘,44,18,8,10
2016/9/30,141097,港北区,錦が丘,45,23,10,13
2016/9/30,141097,港北区,錦が丘,46,32,15,17
2016/9/30,141097,港北区,錦が丘,47,25,11,14
2016/9/30,141097,港北区,錦が丘,48,21,12,9
2016/9/30,141097,港北区,錦が丘,49,27,16,11
2016/9/30,141097,港北区,錦が丘,50,29,12,17
2016/9/30,141097,港北区,錦が丘,51,27,14,13
2016/9/30,141097,港北区,錦が丘,52,23,10,13
2016/9/30,141097,港北区,錦が丘,53,16,7,9
2016/9/30,141097,港北区,錦が丘,54,25,9,16
2016/9/30,141097,港北区,錦が丘,55,31,17,14
2016/9/30,141097,港北区,錦が丘,56,30,24,6
2016/9/30,141097,港北区,錦が丘,57,23,10,13
2016/9/30,141097,港北区,錦が丘,58,15,10,5
2016/9/30,141097,港北区,錦が丘,59,19,9,10
2016/9/30,141097,港北区,錦が丘,60,20,10,10
2016/9/30,141097,港北区,錦が丘,61,19,9,10
2016/9/30,141097,港北区,錦が丘,62,15,8,7
2016/9/30,141097,港北区,錦が丘,63,18,11,7
2016/9/30,141097,港北区,錦が丘,64,25,10,15
2016/9/30,141097,港北区,錦が丘,65,37,19,18
2016/9/30,141097,港北区,錦が丘,66,19,12,7
2016/9/30,141097,港北区,錦が丘,67,22,7,15
2016/9/30,141097,港北区,錦が丘,68,22,11,11
2016/9/30,141097,港北区,錦が丘,69,20,9,11
2016/9/30,141097,港北区,錦が丘,70,10,2,8
2016/9/30,141097,港北区,錦が丘,71,12,5,7
2016/9/30,141097,港北区,錦が丘,72,23,15,8
2016/9/30,141097,港北区,錦が丘,73,15,10,5
2016/9/30,141097,港北区,錦が丘,74,16,9,7
2016/9/30,141097,港北区,錦が丘,75,15,7,8
2016/9/30,141097,港北区,錦が丘,76,20,9,11
2016/9/30,141097,港北区,錦が丘,77,14,9,5
2016/9/30,141097,港北区,錦が丘,78,8,1,7
2016/9/30,141097,港北区,錦が丘,79,8,3,5
2016/9/30,141097,港北区,錦が丘,80,20,9,11
2016/9/30,141097,港北区,錦が丘,81,15,6,9
2016/9/30,141097,港北区,錦が丘,82,11,3,8
2016/9/30,141097,港北区,錦が丘,83,12,5,7
2016/9/30,141097,港北区,錦が丘,84,16,5,11
2016/9/30,141097,港北区,錦が丘,85,10,2,8
2016/9/30,141097,港北区,錦が丘,86,14,4,10
2016/9/30,141097,港北区,錦が丘,87,11,3,8
2016/9/30,141097,港北区,錦が丘,88,9,1,8
2016/9/30,141097,港北区,錦が丘,89,7,0,7
2016/9/30,141097,港北区,錦が丘,90,6,2,4
2016/9/30,141097,港北区,錦が丘,91,5,1,4
2016/9/30,141097,港北区,錦が丘,92,9,5,4
2016/9/30,141097,港北区,錦が丘,93,3,1,2
2016/9/30,141097,港北区,錦が丘,94,1,1,0
2016/9/30,141097,港北区,錦が丘,95,1,0,1
2016/9/30,141097,港北区,錦が丘,96,1,0,1
2016/9/30,141097,港北区,錦が丘,97,1,0,1
2016/9/30,141097,港北区,錦が丘,98,0,0,0
2016/9/30,141097,港北区,錦が丘,99,2,2,0
2016/9/30,141097,港北区,錦が丘,100,1,0,1
2016/9/30,141097,港北区,篠原北一丁目,合計,2670,1346,1324
2016/9/30,141097,港北区,篠原北一丁目,0,13,3,10
2016/9/30,141097,港北区,篠原北一丁目,1,11,4,7
2016/9/30,141097,港北区,篠原北一丁目,2,15,8,7
2016/9/30,141097,港北区,篠原北一丁目,3,15,10,5
2016/9/30,141097,港北区,篠原北一丁目,4,9,5,4
2016/9/30,141097,港北区,篠原北一丁目,5,18,15,3
2016/9/30,141097,港北区,篠原北一丁目,6,11,4,7
2016/9/30,141097,港北区,篠原北一丁目,7,14,6,8
2016/9/30,141097,港北区,篠原北一丁目,8,14,11,3
2016/9/30,141097,港北区,篠原北一丁目,9,12,7,5
2016/9/30,141097,港北区,篠原北一丁目,10,19,13,6
2016/9/30,141097,港北区,篠原北一丁目,11,15,9,6
2016/9/30,141097,港北区,篠原北一丁目,12,17,6,11
2016/9/30,141097,港北区,篠原北一丁目,13,22,6,16
2016/9/30,141097,港北区,篠原北一丁目,14,25,13,12
2016/9/30,141097,港北区,篠原北一丁目,15,22,15,7
2016/9/30,141097,港北区,篠原北一丁目,16,21,9,12
2016/9/30,141097,港北区,篠原北一丁目,17,23,15,8
2016/9/30,141097,港北区,篠原北一丁目,18,15,11,4
2016/9/30,141097,港北区,篠原北一丁目,19,23,13,10
2016/9/30,141097,港北区,篠原北一丁目,20,24,7,17
2016/9/30,141097,港北区,篠原北一丁目,21,30,13,17
2016/9/30,141097,港北区,篠原北一丁目,22,33,13,20
2016/9/30,141097,港北区,篠原北一丁目,23,42,18,24
2016/9/30,141097,港北区,篠原北一丁目,24,40,23,17
2016/9/30,141097,港北区,篠原北一丁目,25,68,38,30
2016/9/30,141097,港北区,篠原北一丁目,26,42,20,22
2016/9/30,141097,港北区,篠原北一丁目,27,62,38,24
2016/9/30,141097,港北区,篠原北一丁目,28,51,27,24
2016/9/30,141097,港北区,篠原北一丁目,29,47,29,18
2016/9/30,141097,港北区,篠原北一丁目,30,52,34,18
2016/9/30,141097,港北区,篠原北一丁目,31,48,23,25
2016/9/30,141097,港北区,篠原北一丁目,32,33,19,14
2016/9/30,141097,港北区,篠原北一丁目,33,37,21,16
2016/9/30,141097,港北区,篠原北一丁目,34,29,16,13
2016/9/30,141097,港北区,篠原北一丁目,35,44,22,22
2016/9/30,141097,港北区,篠原北一丁目,36,31,14,17
2016/9/30,141097,港北区,篠原北一丁目,37,32,24,8
2016/9/30,141097,港北区,篠原北一丁目,38,35,16,19
2016/9/30,141097,港北区,篠原北一丁目,39,39,21,18
2016/9/30,141097,港北区,篠原北一丁目,40,36,17,19
2016/9/30,141097,港北区,篠原北一丁目,41,30,19,11
2016/9/30,141097,港北区,篠原北一丁目,42,41,17,24
2016/9/30,141097,港北区,篠原北一丁目,43,45,19,26
2016/9/30,141097,港北区,篠原北一丁目,44,39,17,22
2016/9/30,141097,港北区,篠原北一丁目,45,38,19,19
2016/9/30,141097,港北区,篠原北一丁目,46,38,21,17
2016/9/30,141097,港北区,篠原北一丁目,47,44,23,21
2016/9/30,141097,港北区,篠原北一丁目,48,45,26,19
2016/9/30,141097,港北区,篠原北一丁目,49,43,21,22
2016/9/30,141097,港北区,篠原北一丁目,50,30,13,17
2016/9/30,141097,港北区,篠原北一丁目,51,37,18,19
2016/9/30,141097,港北区,篠原北一丁目,52,41,18,23
2016/9/30,141097,港北区,篠原北一丁目,53,37,23,14
2016/9/30,141097,港北区,篠原北一丁目,54,30,18,12
2016/9/30,141097,港北区,篠原北一丁目,55,33,14,19
2016/9/30,141097,港北区,篠原北一丁目,56,36,25,11
2016/9/30,141097,港北区,篠原北一丁目,57,37,21,16
2016/9/30,141097,港北区,篠原北一丁目,58,31,17,14
2016/9/30,141097,港北区,篠原北一丁目,59,38,20,18
2016/9/30,141097,港北区,篠原北一丁目,60,40,20,20
2016/9/30,141097,港北区,篠原北一丁目,61,33,17,16
2016/9/30,141097,港北区,篠原北一丁目,62,34,15,19
2016/9/30,141097,港北区,篠原北一丁目,63,29,15,14
2016/9/30,141097,港北区,篠原北一丁目,64,33,18,15
2016/9/30,141097,港北区,篠原北一丁目,65,35,18,17
2016/9/30,141097,港北区,篠原北一丁目,66,34,14,20
2016/9/30,141097,港北区,篠原北一丁目,67,28,14,14
2016/9/30,141097,港北区,篠原北一丁目,68,38,16,22
2016/9/30,141097,港北区,篠原北一丁目,69,38,19,19
2016/9/30,141097,港北区,篠原北一丁目,70,27,9,18
2016/9/30,141097,港北区,篠原北一丁目,71,25,18,7
2016/9/30,141097,港北区,篠原北一丁目,72,28,13,15
2016/9/30,141097,港北区,篠原北一丁目,73,24,15,9
2016/9/30,141097,港北区,篠原北一丁目,74,21,9,12
2016/9/30,141097,港北区,篠原北一丁目,75,14,6,8
2016/9/30,141097,港北区,篠原北一丁目,76,24,9,15
2016/9/30,141097,港北区,篠原北一丁目,77,22,8,14
2016/9/30,141097,港北区,篠原北一丁目,78,14,8,6
2016/9/30,141097,港北区,篠原北一丁目,79,19,9,10
2016/9/30,141097,港北区,篠原北一丁目,80,19,8,11
2016/9/30,141097,港北区,篠原北一丁目,81,16,5,11
2016/9/30,141097,港北区,篠原北一丁目,82,22,7,15
2016/9/30,141097,港北区,篠原北一丁目,83,15,2,13
2016/9/30,141097,港北区,篠原北一丁目,84,17,7,10
2016/9/30,141097,港北区,篠原北一丁目,85,16,4,12
2016/9/30,141097,港北区,篠原北一丁目,86,13,4,9
2016/9/30,141097,港北区,篠原北一丁目,87,20,7,13
2016/9/30,141097,港北区,篠原北一丁目,88,13,4,9
2016/9/30,141097,港北区,篠原北一丁目,89,12,4,8
2016/9/30,141097,港北区,篠原北一丁目,90,10,3,7
2016/9/30,141097,港北区,篠原北一丁目,91,8,5,3
2016/9/30,141097,港北区,篠原北一丁目,92,8,4,4
2016/9/30,141097,港北区,篠原北一丁目,93,4,1,3
2016/9/30,141097,港北区,篠原北一丁目,94,5,2,3
2016/9/30,141097,港北区,篠原北一丁目,95,3,1,2
2016/9/30,141097,港北区,篠原北一丁目,96,1,0,1
2016/9/30,141097,港北区,篠原北一丁目,97,2,1,1
2016/9/30,141097,港北区,篠原北一丁目,98,2,1,1
2016/9/30,141097,港北区,篠原北一丁目,99,1,1,0
2016/9/30,141097,港北区,篠原北一丁目,100,1,0,1
2016/9/30,141097,港北区,篠原北二丁目,合計,1615,793,822
2016/9/30,141097,港北区,篠原北二丁目,0,14,7,7
2016/9/30,141097,港北区,篠原北二丁目,1,9,3,6
2016/9/30,141097,港北区,篠原北二丁目,2,8,5,3
2016/9/30,141097,港北区,篠原北二丁目,3,3,2,1
2016/9/30,141097,港北区,篠原北二丁目,4,7,6,1
2016/9/30,141097,港北区,篠原北二丁目,5,11,8,3
2016/9/30,141097,港北区,篠原北二丁目,6,5,3,2
2016/9/30,141097,港北区,篠原北二丁目,7,6,3,3
2016/9/30,141097,港北区,篠原北二丁目,8,6,3,3
2016/9/30,141097,港北区,篠原北二丁目,9,7,4,3
2016/9/30,141097,港北区,篠原北二丁目,10,5,2,3
2016/9/30,141097,港北区,篠原北二丁目,11,9,3,6
2016/9/30,141097,港北区,篠原北二丁目,12,6,2,4
2016/9/30,141097,港北区,篠原北二丁目,13,10,6,4
2016/9/30,141097,港北区,篠原北二丁目,14,12,6,6
2016/9/30,141097,港北区,篠原北二丁目,15,12,7,5
2016/9/30,141097,港北区,篠原北二丁目,16,13,5,8
2016/9/30,141097,港北区,篠原北二丁目,17,15,7,8
2016/9/30,141097,港北区,篠原北二丁目,18,12,3,9
2016/9/30,141097,港北区,篠原北二丁目,19,10,6,4
2016/9/30,141097,港北区,篠原北二丁目,20,15,7,8
2016/9/30,141097,港北区,篠原北二丁目,21,11,5,6
2016/9/30,141097,港北区,篠原北二丁目,22,27,15,12
2016/9/30,141097,港北区,篠原北二丁目,23,21,16,5
2016/9/30,141097,港北区,篠原北二丁目,24,26,10,16
2016/9/30,141097,港北区,篠原北二丁目,25,26,10,16
2016/9/30,141097,港北区,篠原北二丁目,26,17,10,7
2016/9/30,141097,港北区,篠原北二丁目,27,45,26,19
2016/9/30,141097,港北区,篠原北二丁目,28,30,19,11
2016/9/30,141097,港北区,篠原北二丁目,29,34,17,17
2016/9/30,141097,港北区,篠原北二丁目,30,21,11,10
2016/9/30,141097,港北区,篠原北二丁目,31,24,11,13
2016/9/30,141097,港北区,篠原北二丁目,32,26,15,11
2016/9/30,141097,港北区,篠原北二丁目,33,32,18,14
2016/9/30,141097,港北区,篠原北二丁目,34,19,14,5
2016/9/30,141097,港北区,篠原北二丁目,35,27,12,15
2016/9/30,141097,港北区,篠原北二丁目,36,17,8,9
2016/9/30,141097,港北区,篠原北二丁目,37,29,10,19
2016/9/30,141097,港北区,篠原北二丁目,38,25,17,8
2016/9/30,141097,港北区,篠原北二丁目,39,13,7,6
2016/9/30,141097,港北区,篠原北二丁目,40,26,10,16
2016/9/30,141097,港北区,篠原北二丁目,41,34,15,19
2016/9/30,141097,港北区,篠原北二丁目,42,20,10,10
2016/9/30,141097,港北区,篠原北二丁目,43,35,19,16
2016/9/30,141097,港北区,篠原北二丁目,44,27,15,12
2016/9/30,141097,港北区,篠原北二丁目,45,25,14,11
2016/9/30,141097,港北区,篠原北二丁目,46,22,10,12
2016/9/30,141097,港北区,篠原北二丁目,47,29,14,15
2016/9/30,141097,港北区,篠原北二丁目,48,20,14,6
2016/9/30,141097,港北区,篠原北二丁目,49,28,15,13
2016/9/30,141097,港北区,篠原北二丁目,50,14,7,7
2016/9/30,141097,港北区,篠原北二丁目,51,36,20,16
2016/9/30,141097,港北区,篠原北二丁目,52,23,13,10
2016/9/30,141097,港北区,篠原北二丁目,53,16,7,9
2016/9/30,141097,港北区,篠原北二丁目,54,22,11,11
2016/9/30,141097,港北区,篠原北二丁目,55,17,9,8
2016/9/30,141097,港北区,篠原北二丁目,56,15,11,4
2016/9/30,141097,港北区,篠原北二丁目,57,20,7,13
2016/9/30,141097,港北区,篠原北二丁目,58,22,7,15
2016/9/30,141097,港北区,篠原北二丁目,59,15,9,6
2016/9/30,141097,港北区,篠原北二丁目,60,24,11,13
2016/9/30,141097,港北区,篠原北二丁目,61,20,10,10
2016/9/30,141097,港北区,篠原北二丁目,62,14,10,4
2016/9/30,141097,港北区,篠原北二丁目,63,16,8,8
2016/9/30,141097,港北区,篠原北二丁目,64,12,9,3
2016/9/30,141097,港北区,篠原北二丁目,65,22,7,15
2016/9/30,141097,港北区,篠原北二丁目,66,25,7,18
2016/9/30,141097,港北区,篠原北二丁目,67,21,10,11
2016/9/30,141097,港北区,篠原北二丁目,68,29,15,14
2016/9/30,141097,港北区,篠原北二丁目,69,20,8,12
2016/9/30,141097,港北区,篠原北二丁目,70,11,2,9
2016/9/30,141097,港北区,篠原北二丁目,71,15,9,6
2016/9/30,141097,港北区,篠原北二丁目,72,14,5,9
2016/9/30,141097,港北区,篠原北二丁目,73,19,9,10
2016/9/30,141097,港北区,篠原北二丁目,74,16,7,9
2016/9/30,141097,港北区,篠原北二丁目,75,13,5,8
2016/9/30,141097,港北区,篠原北二丁目,76,15,5,10
2016/9/30,141097,港北区,篠原北二丁目,77,8,4,4
2016/9/30,141097,港北区,篠原北二丁目,78,14,6,8
2016/9/30,141097,港北区,篠原北二丁目,79,11,2,9
2016/9/30,141097,港北区,篠原北二丁目,80,15,6,9
2016/9/30,141097,港北区,篠原北二丁目,81,15,8,7
2016/9/30,141097,港北区,篠原北二丁目,82,14,6,8
2016/9/30,141097,港北区,篠原北二丁目,83,13,8,5
2016/9/30,141097,港北区,篠原北二丁目,84,6,5,1
2016/9/30,141097,港北区,篠原北二丁目,85,12,5,7
2016/9/30,141097,港北区,篠原北二丁目,86,7,2,5
2016/9/30,141097,港北区,篠原北二丁目,87,10,1,9
2016/9/30,141097,港北区,篠原北二丁目,88,7,2,5
2016/9/30,141097,港北区,篠原北二丁目,89,4,1,3
2016/9/30,141097,港北区,篠原北二丁目,90,11,3,8
2016/9/30,141097,港北区,篠原北二丁目,91,5,1,4
2016/9/30,141097,港北区,篠原北二丁目,92,5,2,3
2016/9/30,141097,港北区,篠原北二丁目,93,4,1,3
2016/9/30,141097,港北区,篠原北二丁目,94,6,1,5
2016/9/30,141097,港北区,篠原北二丁目,95,3,2,1
2016/9/30,141097,港北区,篠原北二丁目,96,5,3,2
2016/9/30,141097,港北区,篠原北二丁目,97,0,0,0
2016/9/30,141097,港北区,篠原北二丁目,98,1,0,1
2016/9/30,141097,港北区,篠原北二丁目,99,0,0,0
2016/9/30,141097,港北区,篠原北二丁目,100,2,1,1
2016/9/30,141097,港北区,岸根町,合計,4073,2108,1965
2016/9/30,141097,港北区,岸根町,0,44,20,24
2016/9/30,141097,港北区,岸根町,1,48,21,27
2016/9/30,141097,港北区,岸根町,2,36,25,11
2016/9/30,141097,港北区,岸根町,3,26,13,13
2016/9/30,141097,港北区,岸根町,4,46,20,26
2016/9/30,141097,港北区,岸根町,5,28,12,16
2016/9/30,141097,港北区,岸根町,6,36,18,18
2016/9/30,141097,港北区,岸根町,7,25,12,13
2016/9/30,141097,港北区,岸根町,8,29,14,15
2016/9/30,141097,港北区,岸根町,9,50,30,20
2016/9/30,141097,港北区,岸根町,10,35,19,16
2016/9/30,141097,港北区,岸根町,11,40,22,18
2016/9/30,141097,港北区,岸根町,12,46,26,20
2016/9/30,141097,港北区,岸根町,13,41,20,21
2016/9/30,141097,港北区,岸根町,14,53,27,26
2016/9/30,141097,港北区,岸根町,15,44,28,16
2016/9/30,141097,港北区,岸根町,16,33,16,17
2016/9/30,141097,港北区,岸根町,17,36,22,14
2016/9/30,141097,港北区,岸根町,18,45,18,27
2016/9/30,141097,港北区,岸根町,19,39,22,17
2016/9/30,141097,港北区,岸根町,20,32,17,15
2016/9/30,141097,港北区,岸根町,21,53,31,22
2016/9/30,141097,港北区,岸根町,22,40,19,21
2016/9/30,141097,港北区,岸根町,23,50,21,29
2016/9/30,141097,港北区,岸根町,24,48,27,21
2016/9/30,141097,港北区,岸根町,25,51,26,25
2016/9/30,141097,港北区,岸根町,26,61,28,33
2016/9/30,141097,港北区,岸根町,27,55,33,22
2016/9/30,141097,港北区,岸根町,28,52,28,24
2016/9/30,141097,港北区,岸根町,29,57,23,34
2016/9/30,141097,港北区,岸根町,30,64,40,24
2016/9/30,141097,港北区,岸根町,31,69,43,26
2016/9/30,141097,港北区,岸根町,32,64,29,35
2016/9/30,141097,港北区,岸根町,33,68,39,29
2016/9/30,141097,港北区,岸根町,34,66,34,32
2016/9/30,141097,港北区,岸根町,35,77,42,35
2016/9/30,141097,港北区,岸根町,36,66,39,27
2016/9/30,141097,港北区,岸根町,37,73,40,33
2016/9/30,141097,港北区,岸根町,38,70,38,32
2016/9/30,141097,港北区,岸根町,39,74,39,35
2016/9/30,141097,港北区,岸根町,40,70,32,38
2016/9/30,141097,港北区,岸根町,41,87,43,44
2016/9/30,141097,港北区,岸根町,42,72,39,33
2016/9/30,141097,港北区,岸根町,43,86,46,40
2016/9/30,141097,港北区,岸根町,44,64,34,30
2016/9/30,141097,港北区,岸根町,45,82,39,43
2016/9/30,141097,港北区,岸根町,46,77,36,41
2016/9/30,141097,港北区,岸根町,47,100,56,44
2016/9/30,141097,港北区,岸根町,48,72,40,32
2016/9/30,141097,港北区,岸根町,49,74,41,33
2016/9/30,141097,港北区,岸根町,50,56,30,26
2016/9/30,141097,港北区,岸根町,51,57,32,25
2016/9/30,141097,港北区,岸根町,52,53,24,29
2016/9/30,141097,港北区,岸根町,53,50,31,19
2016/9/30,141097,港北区,岸根町,54,51,35,16
2016/9/30,141097,港北区,岸根町,55,52,32,20
2016/9/30,141097,港北区,岸根町,56,37,17,20
2016/9/30,141097,港北区,岸根町,57,40,22,18
2016/9/30,141097,港北区,岸根町,58,35,18,17
2016/9/30,141097,港北区,岸根町,59,44,21,23
2016/9/30,141097,港北区,岸根町,60,41,21,20
2016/9/30,141097,港北区,岸根町,61,37,24,13
2016/9/30,141097,港北区,岸根町,62,31,19,12
2016/9/30,141097,港北区,岸根町,63,36,19,17
2016/9/30,141097,港北区,岸根町,64,42,15,27
2016/9/30,141097,港北区,岸根町,65,32,20,12
2016/9/30,141097,港北区,岸根町,66,46,26,20
2016/9/30,141097,港北区,岸根町,67,31,18,13
2016/9/30,141097,港北区,岸根町,68,43,19,24
2016/9/30,141097,港北区,岸根町,69,41,25,16
2016/9/30,141097,港北区,岸根町,70,27,11,16
2016/9/30,141097,港北区,岸根町,71,35,12,23
2016/9/30,141097,港北区,岸根町,72,27,16,11
2016/9/30,141097,港北区,岸根町,73,32,16,16
2016/9/30,141097,港北区,岸根町,74,46,18,28
2016/9/30,141097,港北区,岸根町,75,30,11,19
2016/9/30,141097,港北区,岸根町,76,32,12,20
2016/9/30,141097,港北区,岸根町,77,27,10,17
2016/9/30,141097,港北区,岸根町,78,23,8,15
2016/9/30,141097,港北区,岸根町,79,27,9,18
2016/9/30,141097,港北区,岸根町,80,20,9,11
2016/9/30,141097,港北区,岸根町,81,24,15,9
2016/9/30,141097,港北区,岸根町,82,19,9,10
2016/9/30,141097,港北区,岸根町,83,17,10,7
2016/9/30,141097,港北区,岸根町,84,12,6,6
2016/9/30,141097,港北区,岸根町,85,6,0,6
2016/9/30,141097,港北区,岸根町,86,14,5,9
2016/9/30,141097,港北区,岸根町,87,10,3,7
2016/9/30,141097,港北区,岸根町,88,10,5,5
2016/9/30,141097,港北区,岸根町,89,4,2,2
2016/9/30,141097,港北区,岸根町,90,5,2,3
2016/9/30,141097,港北区,岸根町,91,6,1,5
2016/9/30,141097,港北区,岸根町,92,1,0,1
2016/9/30,141097,港北区,岸根町,93,3,1,2
2016/9/30,141097,港北区,岸根町,94,2,1,1
2016/9/30,141097,港北区,岸根町,95,0,0,0
2016/9/30,141097,港北区,岸根町,96,3,0,3
2016/9/30,141097,港北区,岸根町,97,1,1,0
2016/9/30,141097,港北区,岸根町,98,0,0,0
2016/9/30,141097,港北区,岸根町,99,1,0,1
2016/9/30,141097,港北区,岸根町,100,0,0,0
2016/9/30,141097,港北区,鳥山町,合計,7378,3767,3611
2016/9/30,141097,港北区,鳥山町,0,87,42,45
2016/9/30,141097,港北区,鳥山町,1,69,30,39
2016/9/30,141097,港北区,鳥山町,2,81,45,36
2016/9/30,141097,港北区,鳥山町,3,90,54,36
2016/9/30,141097,港北区,鳥山町,4,65,29,36
2016/9/30,141097,港北区,鳥山町,5,63,31,32
2016/9/30,141097,港北区,鳥山町,6,74,40,34
2016/9/30,141097,港北区,鳥山町,7,57,23,34
2016/9/30,141097,港北区,鳥山町,8,58,32,26
2016/9/30,141097,港北区,鳥山町,9,54,28,26
2016/9/30,141097,港北区,鳥山町,10,70,30,40
2016/9/30,141097,港北区,鳥山町,11,47,26,21
2016/9/30,141097,港北区,鳥山町,12,48,26,22
2016/9/30,141097,港北区,鳥山町,13,62,34,28
2016/9/30,141097,港北区,鳥山町,14,65,36,29
2016/9/30,141097,港北区,鳥山町,15,65,31,34
2016/9/30,141097,港北区,鳥山町,16,69,29,40
2016/9/30,141097,港北区,鳥山町,17,61,27,34
2016/9/30,141097,港北区,鳥山町,18,59,33,26
2016/9/30,141097,港北区,鳥山町,19,78,36,42
2016/9/30,141097,港北区,鳥山町,20,79,43,36
2016/9/30,141097,港北区,鳥山町,21,88,38,50
2016/9/30,141097,港北区,鳥山町,22,91,53,38
2016/9/30,141097,港北区,鳥山町,23,97,45,52
2016/9/30,141097,港北区,鳥山町,24,78,34,44
2016/9/30,141097,港北区,鳥山町,25,81,44,37
2016/9/30,141097,港北区,鳥山町,26,110,56,54
2016/9/30,141097,港北区,鳥山町,27,83,40,43
2016/9/30,141097,港北区,鳥山町,28,107,55,52
2016/9/30,141097,港北区,鳥山町,29,94,44,50
2016/9/30,141097,港北区,鳥山町,30,97,47,50
2016/9/30,141097,港北区,鳥山町,31,117,71,46
2016/9/30,141097,港北区,鳥山町,32,120,61,59
2016/9/30,141097,港北区,鳥山町,33,125,68,57
2016/9/30,141097,港北区,鳥山町,34,120,62,58
2016/9/30,141097,港北区,鳥山町,35,107,53,54
2016/9/30,141097,港北区,鳥山町,36,119,66,53
2016/9/30,141097,港北区,鳥山町,37,131,73,58
2016/9/30,141097,港北区,鳥山町,38,107,66,41
2016/9/30,141097,港北区,鳥山町,39,102,55,47
2016/9/30,141097,港北区,鳥山町,40,97,53,44
2016/9/30,141097,港北区,鳥山町,41,137,78,59
2016/9/30,141097,港北区,鳥山町,42,146,76,70
2016/9/30,141097,港北区,鳥山町,43,132,66,66
2016/9/30,141097,港北区,鳥山町,44,104,56,48
2016/9/30,141097,港北区,鳥山町,45,126,72,54
2016/9/30,141097,港北区,鳥山町,46,131,74,57
2016/9/30,141097,港北区,鳥山町,47,97,49,48
2016/9/30,141097,港北区,鳥山町,48,114,64,50
2016/9/30,141097,港北区,鳥山町,49,111,53,58
2016/9/30,141097,港北区,鳥山町,50,84,32,52
2016/9/30,141097,港北区,鳥山町,51,117,71,46
2016/9/30,141097,港北区,鳥山町,52,83,47,36
2016/9/30,141097,港北区,鳥山町,53,78,35,43
2016/9/30,141097,港北区,鳥山町,54,75,52,23
2016/9/30,141097,港北区,鳥山町,55,80,43,37
2016/9/30,141097,港北区,鳥山町,56,88,43,45
2016/9/30,141097,港北区,鳥山町,57,80,46,34
2016/9/30,141097,港北区,鳥山町,58,90,41,49
2016/9/30,141097,港北区,鳥山町,59,83,43,40
2016/9/30,141097,港北区,鳥山町,60,87,43,44
2016/9/30,141097,港北区,鳥山町,61,90,44,46
2016/9/30,141097,港北区,鳥山町,62,73,40,33
2016/9/30,141097,港北区,鳥山町,63,94,47,47
2016/9/30,141097,港北区,鳥山町,64,104,54,50
2016/9/30,141097,港北区,鳥山町,65,94,52,42
2016/9/30,141097,港北区,鳥山町,66,92,51,41
2016/9/30,141097,港北区,鳥山町,67,109,50,59
2016/9/30,141097,港北区,鳥山町,68,112,67,45
2016/9/30,141097,港北区,鳥山町,69,100,50,50
2016/9/30,141097,港北区,鳥山町,70,68,38,30
2016/9/30,141097,港北区,鳥山町,71,71,31,40
2016/9/30,141097,港北区,鳥山町,72,81,45,36
2016/9/30,141097,港北区,鳥山町,73,79,38,41
2016/9/30,141097,港北区,鳥山町,74,66,30,36
2016/9/30,141097,港北区,鳥山町,75,66,32,34
2016/9/30,141097,港北区,鳥山町,76,65,36,29
2016/9/30,141097,港北区,鳥山町,77,40,21,19
2016/9/30,141097,港北区,鳥山町,78,56,27,29
2016/9/30,141097,港北区,鳥山町,79,44,18,26
2016/9/30,141097,港北区,鳥山町,80,38,21,17
2016/9/30,141097,港北区,鳥山町,81,34,12,22
2016/9/30,141097,港北区,鳥山町,82,43,14,29
2016/9/30,141097,港北区,鳥山町,83,38,18,20
2016/9/30,141097,港北区,鳥山町,84,29,14,15
2016/9/30,141097,港北区,鳥山町,85,23,6,17
2016/9/30,141097,港北区,鳥山町,86,28,9,19
2016/9/30,141097,港北区,鳥山町,87,30,9,21
2016/9/30,141097,港北区,鳥山町,88,21,4,17
2016/9/30,141097,港北区,鳥山町,89,17,6,11
2016/9/30,141097,港北区,鳥山町,90,10,1,9
2016/9/30,141097,港北区,鳥山町,91,10,0,10
2016/9/30,141097,港北区,鳥山町,92,11,4,7
2016/9/30,141097,港北区,鳥山町,93,8,1,7
2016/9/30,141097,港北区,鳥山町,94,8,3,5
2016/9/30,141097,港北区,鳥山町,95,2,1,1
2016/9/30,141097,港北区,鳥山町,96,3,0,3
2016/9/30,141097,港北区,鳥山町,97,2,0,2
2016/9/30,141097,港北区,鳥山町,98,1,0,1
2016/9/30,141097,港北区,鳥山町,99,0,0,0
2016/9/30,141097,港北区,鳥山町,100,3,0,3
2016/9/30,141097,港北区,小机町,合計,12576,6404,6172
2016/9/30,141097,港北区,小机町,0,112,48,64
2016/9/30,141097,港北区,小机町,1,96,47,49
2016/9/30,141097,港北区,小机町,2,96,51,45
2016/9/30,141097,港北区,小机町,3,106,51,55
2016/9/30,141097,港北区,小机町,4,103,48,55
2016/9/30,141097,港北区,小机町,5,111,60,51
2016/9/30,141097,港北区,小机町,6,94,51,43
2016/9/30,141097,港北区,小机町,7,99,44,55
2016/9/30,141097,港北区,小机町,8,115,59,56
2016/9/30,141097,港北区,小机町,9,106,55,51
2016/9/30,141097,港北区,小机町,10,111,57,54
2016/9/30,141097,港北区,小机町,11,101,62,39
2016/9/30,141097,港北区,小机町,12,127,52,75
2016/9/30,141097,港北区,小机町,13,112,58,54
2016/9/30,141097,港北区,小机町,14,125,70,55
2016/9/30,141097,港北区,小机町,15,120,60,60
2016/9/30,141097,港北区,小机町,16,107,54,53
2016/9/30,141097,港北区,小机町,17,115,63,52
2016/9/30,141097,港北区,小机町,18,130,66,64
2016/9/30,141097,港北区,小机町,19,104,43,61
2016/9/30,141097,港北区,小机町,20,104,44,60
2016/9/30,141097,港北区,小机町,21,125,55,70
2016/9/30,141097,港北区,小机町,22,180,79,101
2016/9/30,141097,港北区,小机町,23,181,79,102
2016/9/30,141097,港北区,小机町,24,196,106,90
2016/9/30,141097,港北区,小机町,25,184,84,100
2016/9/30,141097,港北区,小机町,26,181,85,96
2016/9/30,141097,港北区,小机町,27,175,91,84
2016/9/30,141097,港北区,小机町,28,188,103,85
2016/9/30,141097,港北区,小机町,29,166,86,80
2016/9/30,141097,港北区,小机町,30,183,103,80
2016/9/30,141097,港北区,小机町,31,175,95,80
2016/9/30,141097,港北区,小机町,32,193,105,88
2016/9/30,141097,港北区,小机町,33,184,97,87
2016/9/30,141097,港北区,小机町,34,206,110,96
2016/9/30,141097,港北区,小机町,35,154,79,75
2016/9/30,141097,港北区,小机町,36,141,79,62
2016/9/30,141097,港北区,小机町,37,150,78,72
2016/9/30,141097,港北区,小机町,38,202,105,97
2016/9/30,141097,港北区,小机町,39,175,85,90
2016/9/30,141097,港北区,小机町,40,185,105,80
2016/9/30,141097,港北区,小机町,41,191,117,74
2016/9/30,141097,港北区,小机町,42,236,121,115
2016/9/30,141097,港北区,小机町,43,221,115,106
2016/9/30,141097,港北区,小机町,44,236,126,110
2016/9/30,141097,港北区,小机町,45,218,117,101
2016/9/30,141097,港北区,小机町,46,208,115,93
2016/9/30,141097,港北区,小机町,47,228,118,110
2016/9/30,141097,港北区,小机町,48,197,121,76
2016/9/30,141097,港北区,小机町,49,196,99,97
2016/9/30,141097,港北区,小机町,50,134,76,58
2016/9/30,141097,港北区,小机町,51,206,107,99
2016/9/30,141097,港北区,小机町,52,156,82,74
2016/9/30,141097,港北区,小机町,53,132,67,65
2016/9/30,141097,港北区,小机町,54,146,78,68
2016/9/30,141097,港北区,小机町,55,178,98,80
2016/9/30,141097,港北区,小机町,56,164,90,74
2016/9/30,141097,港北区,小机町,57,160,72,88
2016/9/30,141097,港北区,小机町,58,135,75,60
2016/9/30,141097,港北区,小机町,59,142,75,67
2016/9/30,141097,港北区,小机町,60,163,85,78
2016/9/30,141097,港北区,小机町,61,148,82,66
2016/9/30,141097,港北区,小机町,62,152,70,82
2016/9/30,141097,港北区,小机町,63,128,72,56
2016/9/30,141097,港北区,小机町,64,167,83,84
2016/9/30,141097,港北区,小机町,65,157,82,75
2016/9/30,141097,港北区,小机町,66,166,86,80
2016/9/30,141097,港北区,小机町,67,201,93,108
2016/9/30,141097,港北区,小机町,68,177,98,79
2016/9/30,141097,港北区,小机町,69,176,99,77
2016/9/30,141097,港北区,小机町,70,115,65,50
2016/9/30,141097,港北区,小机町,71,113,61,52
2016/9/30,141097,港北区,小机町,72,121,54,67
2016/9/30,141097,港北区,小机町,73,140,72,68
2016/9/30,141097,港北区,小机町,74,134,64,70
2016/9/30,141097,港北区,小机町,75,99,45,54
2016/9/30,141097,港北区,小机町,76,101,54,47
2016/9/30,141097,港北区,小机町,77,75,39,36
2016/9/30,141097,港北区,小机町,78,75,39,36
2016/9/30,141097,港北区,小机町,79,79,32,47
2016/9/30,141097,港北区,小机町,80,82,34,48
2016/9/30,141097,港北区,小机町,81,53,25,28
2016/9/30,141097,港北区,小机町,82,64,20,44
2016/9/30,141097,港北区,小机町,83,59,24,35
2016/9/30,141097,港北区,小机町,84,50,24,26
2016/9/30,141097,港北区,小机町,85,46,19,27
2016/9/30,141097,港北区,小机町,86,34,8,26
2016/9/30,141097,港北区,小机町,87,30,12,18
2016/9/30,141097,港北区,小机町,88,32,10,22
2016/9/30,141097,港北区,小机町,89,31,10,21
2016/9/30,141097,港北区,小机町,90,14,4,10
2016/9/30,141097,港北区,小机町,91,28,8,20
2016/9/30,141097,港北区,小机町,92,12,3,9
2016/9/30,141097,港北区,小机町,93,17,4,13
2016/9/30,141097,港北区,小机町,94,7,0,7
2016/9/30,141097,港北区,小机町,95,9,1,8
2016/9/30,141097,港北区,小机町,96,2,0,2
2016/9/30,141097,港北区,小机町,97,2,0,2
2016/9/30,141097,港北区,小机町,98,6,1,5
2016/9/30,141097,港北区,小机町,99,5,0,5
2016/9/30,141097,港北区,小机町,100,4,1,3
2016/9/30,141097,港北区,大豆戸町,合計,14002,6760,7242
2016/9/30,141097,港北区,大豆戸町,0,98,52,46
2016/9/30,141097,港北区,大豆戸町,1,117,58,59
2016/9/30,141097,港北区,大豆戸町,2,100,49,51
2016/9/30,141097,港北区,大豆戸町,3,116,59,57
2016/9/30,141097,港北区,大豆戸町,4,104,47,57
2016/9/30,141097,港北区,大豆戸町,5,110,57,53
2016/9/30,141097,港北区,大豆戸町,6,105,61,44
2016/9/30,141097,港北区,大豆戸町,7,109,55,54
2016/9/30,141097,港北区,大豆戸町,8,103,59,44
2016/9/30,141097,港北区,大豆戸町,9,117,69,48
2016/9/30,141097,港北区,大豆戸町,10,112,60,52
2016/9/30,141097,港北区,大豆戸町,11,104,47,57
2016/9/30,141097,港北区,大豆戸町,12,113,53,60
2016/9/30,141097,港北区,大豆戸町,13,134,66,68
2016/9/30,141097,港北区,大豆戸町,14,111,70,41
2016/9/30,141097,港北区,大豆戸町,15,117,59,58
2016/9/30,141097,港北区,大豆戸町,16,123,63,60
2016/9/30,141097,港北区,大豆戸町,17,119,51,68
2016/9/30,141097,港北区,大豆戸町,18,120,56,64
2016/9/30,141097,港北区,大豆戸町,19,123,63,60
2016/9/30,141097,港北区,大豆戸町,20,156,75,81
2016/9/30,141097,港北区,大豆戸町,21,128,71,57
2016/9/30,141097,港北区,大豆戸町,22,126,56,70
2016/9/30,141097,港北区,大豆戸町,23,158,74,84
2016/9/30,141097,港北区,大豆戸町,24,160,81,79
2016/9/30,141097,港北区,大豆戸町,25,154,72,82
2016/9/30,141097,港北区,大豆戸町,26,169,71,98
2016/9/30,141097,港北区,大豆戸町,27,164,64,100
2016/9/30,141097,港北区,大豆戸町,28,159,89,70
2016/9/30,141097,港北区,大豆戸町,29,177,92,85
2016/9/30,141097,港北区,大豆戸町,30,181,77,104
2016/9/30,141097,港北区,大豆戸町,31,175,91,84
2016/9/30,141097,港北区,大豆戸町,32,177,79,98
2016/9/30,141097,港北区,大豆戸町,33,212,118,94
2016/9/30,141097,港北区,大豆戸町,34,199,95,104
2016/9/30,141097,港北区,大豆戸町,35,229,103,126
2016/9/30,141097,港北区,大豆戸町,36,169,82,87
2016/9/30,141097,港北区,大豆戸町,37,197,96,101
2016/9/30,141097,港北区,大豆戸町,38,185,92,93
2016/9/30,141097,港北区,大豆戸町,39,216,106,110
2016/9/30,141097,港北区,大豆戸町,40,218,106,112
2016/9/30,141097,港北区,大豆戸町,41,245,116,129
2016/9/30,141097,港北区,大豆戸町,42,264,115,149
2016/9/30,141097,港北区,大豆戸町,43,240,127,113
2016/9/30,141097,港北区,大豆戸町,44,255,126,129
2016/9/30,141097,港北区,大豆戸町,45,258,129,129
2016/9/30,141097,港北区,大豆戸町,46,245,112,133
2016/9/30,141097,港北区,大豆戸町,47,206,110,96
2016/9/30,141097,港北区,大豆戸町,48,269,134,135
2016/9/30,141097,港北区,大豆戸町,49,240,133,107
2016/9/30,141097,港北区,大豆戸町,50,200,89,111
2016/9/30,141097,港北区,大豆戸町,51,211,104,107
2016/9/30,141097,港北区,大豆戸町,52,219,113,106
2016/9/30,141097,港北区,大豆戸町,53,215,109,106
2016/9/30,141097,港北区,大豆戸町,54,220,109,111
2016/9/30,141097,港北区,大豆戸町,55,208,103,105
2016/9/30,141097,港北区,大豆戸町,56,162,88,74
2016/9/30,141097,港北区,大豆戸町,57,194,90,104
2016/9/30,141097,港北区,大豆戸町,58,179,90,89
2016/9/30,141097,港北区,大豆戸町,59,144,75,69
2016/9/30,141097,港北区,大豆戸町,60,155,61,94
2016/9/30,141097,港北区,大豆戸町,61,179,103,76
2016/9/30,141097,港北区,大豆戸町,62,162,74,88
2016/9/30,141097,港北区,大豆戸町,63,154,77,77
2016/9/30,141097,港北区,大豆戸町,64,170,72,98
2016/9/30,141097,港北区,大豆戸町,65,181,93,88
2016/9/30,141097,港北区,大豆戸町,66,207,99,108
2016/9/30,141097,港北区,大豆戸町,67,249,121,128
2016/9/30,141097,港北区,大豆戸町,68,212,102,110
2016/9/30,141097,港北区,大豆戸町,69,207,95,112
2016/9/30,141097,港北区,大豆戸町,70,132,69,63
2016/9/30,141097,港北区,大豆戸町,71,148,68,80
2016/9/30,141097,港北区,大豆戸町,72,142,72,70
2016/9/30,141097,港北区,大豆戸町,73,156,66,90
2016/9/30,141097,港北区,大豆戸町,74,148,69,79
2016/9/30,141097,港北区,大豆戸町,75,127,63,64
2016/9/30,141097,港北区,大豆戸町,76,106,47,59
2016/9/30,141097,港北区,大豆戸町,77,94,56,38
2016/9/30,141097,港北区,大豆戸町,78,75,29,46
2016/9/30,141097,港北区,大豆戸町,79,94,42,52
2016/9/30,141097,港北区,大豆戸町,80,112,51,61
2016/9/30,141097,港北区,大豆戸町,81,113,46,67
2016/9/30,141097,港北区,大豆戸町,82,69,25,44
2016/9/30,141097,港北区,大豆戸町,83,63,24,39
2016/9/30,141097,港北区,大豆戸町,84,58,19,39
2016/9/30,141097,港北区,大豆戸町,85,37,14,23
2016/9/30,141097,港北区,大豆戸町,86,55,24,31
2016/9/30,141097,港北区,大豆戸町,87,50,18,32
2016/9/30,141097,港北区,大豆戸町,88,40,7,33
2016/9/30,141097,港北区,大豆戸町,89,33,10,23
2016/9/30,141097,港北区,大豆戸町,90,29,5,24
2016/9/30,141097,港北区,大豆戸町,91,27,4,23
2016/9/30,141097,港北区,大豆戸町,92,14,4,10
2016/9/30,141097,港北区,大豆戸町,93,24,9,15
2016/9/30,141097,港北区,大豆戸町,94,14,2,12
2016/9/30,141097,港北区,大豆戸町,95,7,1,6
2016/9/30,141097,港北区,大豆戸町,96,9,2,7
2016/9/30,141097,港北区,大豆戸町,97,3,0,3
2016/9/30,141097,港北区,大豆戸町,98,3,1,2
2016/9/30,141097,港北区,大豆戸町,99,2,0,2
2016/9/30,141097,港北区,大豆戸町,100,4,0,4
2016/9/30,141097,港北区,師岡町,合計,10483,5159,5324
2016/9/30,141097,港北区,師岡町,0,102,63,39
2016/9/30,141097,港北区,師岡町,1,91,42,49
2016/9/30,141097,港北区,師岡町,2,115,64,51
2016/9/30,141097,港北区,師岡町,3,94,50,44
2016/9/30,141097,港北区,師岡町,4,106,53,53
2016/9/30,141097,港北区,師岡町,5,111,50,61
2016/9/30,141097,港北区,師岡町,6,85,43,42
2016/9/30,141097,港北区,師岡町,7,87,42,45
2016/9/30,141097,港北区,師岡町,8,91,39,52
2016/9/30,141097,港北区,師岡町,9,97,57,40
2016/9/30,141097,港北区,師岡町,10,108,54,54
2016/9/30,141097,港北区,師岡町,11,91,51,40
2016/9/30,141097,港北区,師岡町,12,104,41,63
2016/9/30,141097,港北区,師岡町,13,83,39,44
2016/9/30,141097,港北区,師岡町,14,109,51,58
2016/9/30,141097,港北区,師岡町,15,95,48,47
2016/9/30,141097,港北区,師岡町,16,93,45,48
2016/9/30,141097,港北区,師岡町,17,100,49,51
2016/9/30,141097,港北区,師岡町,18,102,51,51
2016/9/30,141097,港北区,師岡町,19,102,55,47
2016/9/30,141097,港北区,師岡町,20,98,44,54
2016/9/30,141097,港北区,師岡町,21,94,56,38
2016/9/30,141097,港北区,師岡町,22,96,53,43
2016/9/30,141097,港北区,師岡町,23,102,55,47
2016/9/30,141097,港北区,師岡町,24,104,49,55
2016/9/30,141097,港北区,師岡町,25,111,55,56
2016/9/30,141097,港北区,師岡町,26,95,43,52
2016/9/30,141097,港北区,師岡町,27,100,51,49
2016/9/30,141097,港北区,師岡町,28,102,47,55
2016/9/30,141097,港北区,師岡町,29,118,62,56
2016/9/30,141097,港北区,師岡町,30,130,67,63
2016/9/30,141097,港北区,師岡町,31,151,77,74
2016/9/30,141097,港北区,師岡町,32,160,80,80
2016/9/30,141097,港北区,師岡町,33,164,95,69
2016/9/30,141097,港北区,師岡町,34,147,82,65
2016/9/30,141097,港北区,師岡町,35,153,76,77
2016/9/30,141097,港北区,師岡町,36,178,88,90
2016/9/30,141097,港北区,師岡町,37,169,81,88
2016/9/30,141097,港北区,師岡町,38,165,85,80
2016/9/30,141097,港北区,師岡町,39,170,87,83
2016/9/30,141097,港北区,師岡町,40,185,92,93
2016/9/30,141097,港北区,師岡町,41,192,84,108
2016/9/30,141097,港北区,師岡町,42,186,87,99
2016/9/30,141097,港北区,師岡町,43,217,124,93
2016/9/30,141097,港北区,師岡町,44,177,85,92
2016/9/30,141097,港北区,師岡町,45,208,99,109
2016/9/30,141097,港北区,師岡町,46,182,90,92
2016/9/30,141097,港北区,師岡町,47,204,105,99
2016/9/30,141097,港北区,師岡町,48,190,102,88
2016/9/30,141097,港北区,師岡町,49,191,93,98
2016/9/30,141097,港北区,師岡町,50,153,83,70
2016/9/30,141097,港北区,師岡町,51,164,82,82
2016/9/30,141097,港北区,師岡町,52,170,81,89
2016/9/30,141097,港北区,師岡町,53,151,89,62
2016/9/30,141097,港北区,師岡町,54,135,66,69
2016/9/30,141097,港北区,師岡町,55,147,79,68
2016/9/30,141097,港北区,師岡町,56,144,68,76
2016/9/30,141097,港北区,師岡町,57,103,47,56
2016/9/30,141097,港北区,師岡町,58,101,49,52
2016/9/30,141097,港北区,師岡町,59,105,50,55
2016/9/30,141097,港北区,師岡町,60,101,50,51
2016/9/30,141097,港北区,師岡町,61,119,64,55
2016/9/30,141097,港北区,師岡町,62,106,52,54
2016/9/30,141097,港北区,師岡町,63,110,51,59
2016/9/30,141097,港北区,師岡町,64,113,56,57
2016/9/30,141097,港北区,師岡町,65,121,56,65
2016/9/30,141097,港北区,師岡町,66,125,64,61
2016/9/30,141097,港北区,師岡町,67,131,58,73
2016/9/30,141097,港北区,師岡町,68,158,81,77
2016/9/30,141097,港北区,師岡町,69,138,65,73
2016/9/30,141097,港北区,師岡町,70,85,37,48
2016/9/30,141097,港北区,師岡町,71,92,41,51
2016/9/30,141097,港北区,師岡町,72,107,51,56
2016/9/30,141097,港北区,師岡町,73,111,50,61
2016/9/30,141097,港北区,師岡町,74,77,40,37
2016/9/30,141097,港北区,師岡町,75,91,37,54
2016/9/30,141097,港北区,師岡町,76,74,33,41
2016/9/30,141097,港北区,師岡町,77,64,25,39
2016/9/30,141097,港北区,師岡町,78,69,29,40
2016/9/30,141097,港北区,師岡町,79,66,29,37
2016/9/30,141097,港北区,師岡町,80,66,30,36
2016/9/30,141097,港北区,師岡町,81,74,29,45
2016/9/30,141097,港北区,師岡町,82,53,20,33
2016/9/30,141097,港北区,師岡町,83,43,18,25
2016/9/30,141097,港北区,師岡町,84,49,25,24
2016/9/30,141097,港北区,師岡町,85,48,22,26
2016/9/30,141097,港北区,師岡町,86,40,20,20
2016/9/30,141097,港北区,師岡町,87,21,5,16
2016/9/30,141097,港北区,師岡町,88,29,7,22
2016/9/30,141097,港北区,師岡町,89,28,9,19
2016/9/30,141097,港北区,師岡町,90,19,7,12
2016/9/30,141097,港北区,師岡町,91,21,4,17
2016/9/30,141097,港北区,師岡町,92,12,6,6
2016/9/30,141097,港北区,師岡町,93,12,5,7
2016/9/30,141097,港北区,師岡町,94,10,2,8
2016/9/30,141097,港北区,師岡町,95,6,1,5
2016/9/30,141097,港北区,師岡町,96,5,1,4
2016/9/30,141097,港北区,師岡町,97,3,1,2
2016/9/30,141097,港北区,師岡町,98,3,1,2
2016/9/30,141097,港北区,師岡町,99,3,1,2
2016/9/30,141097,港北区,師岡町,100,2,1,1
2016/9/30,141097,港北区,新羽町,合計,12165,6300,5865
2016/9/30,141097,港北区,新羽町,0,144,88,56
2016/9/30,141097,港北区,新羽町,1,109,61,48
2016/9/30,141097,港北区,新羽町,2,94,41,53
2016/9/30,141097,港北区,新羽町,3,101,63,38
2016/9/30,141097,港北区,新羽町,4,89,51,38
2016/9/30,141097,港北区,新羽町,5,104,54,50
2016/9/30,141097,港北区,新羽町,6,74,45,29
2016/9/30,141097,港北区,新羽町,7,98,40,58
2016/9/30,141097,港北区,新羽町,8,92,45,47
2016/9/30,141097,港北区,新羽町,9,99,45,54
2016/9/30,141097,港北区,新羽町,10,106,45,61
2016/9/30,141097,港北区,新羽町,11,111,57,54
2016/9/30,141097,港北区,新羽町,12,100,54,46
2016/9/30,141097,港北区,新羽町,13,106,61,45
2016/9/30,141097,港北区,新羽町,14,133,67,66
2016/9/30,141097,港北区,新羽町,15,107,52,55
2016/9/30,141097,港北区,新羽町,16,120,73,47
2016/9/30,141097,港北区,新羽町,17,117,64,53
2016/9/30,141097,港北区,新羽町,18,113,46,67
2016/9/30,141097,港北区,新羽町,19,100,47,53
2016/9/30,141097,港北区,新羽町,20,106,63,43
2016/9/30,141097,港北区,新羽町,21,129,66,63
2016/9/30,141097,港北区,新羽町,22,117,49,68
2016/9/30,141097,港北区,新羽町,23,142,64,78
2016/9/30,141097,港北区,新羽町,24,147,70,77
2016/9/30,141097,港北区,新羽町,25,128,61,67
2016/9/30,141097,港北区,新羽町,26,155,79,76
2016/9/30,141097,港北区,新羽町,27,153,82,71
2016/9/30,141097,港北区,新羽町,28,154,80,74
2016/9/30,141097,港北区,新羽町,29,177,84,93
2016/9/30,141097,港北区,新羽町,30,184,102,82
2016/9/30,141097,港北区,新羽町,31,170,91,79
2016/9/30,141097,港北区,新羽町,32,164,92,72
2016/9/30,141097,港北区,新羽町,33,169,89,80
2016/9/30,141097,港北区,新羽町,34,157,93,64
2016/9/30,141097,港北区,新羽町,35,160,80,80
2016/9/30,141097,港北区,新羽町,36,171,87,84
2016/9/30,141097,港北区,新羽町,37,165,90,75
2016/9/30,141097,港北区,新羽町,38,203,108,95
2016/9/30,141097,港北区,新羽町,39,229,121,108
2016/9/30,141097,港北区,新羽町,40,208,104,104
2016/9/30,141097,港北区,新羽町,41,222,117,105
2016/9/30,141097,港北区,新羽町,42,258,134,124
2016/9/30,141097,港北区,新羽町,43,232,115,117
2016/9/30,141097,港北区,新羽町,44,258,151,107
2016/9/30,141097,港北区,新羽町,45,283,149,134
2016/9/30,141097,港北区,新羽町,46,256,142,114
2016/9/30,141097,港北区,新羽町,47,274,138,136
2016/9/30,141097,港北区,新羽町,48,276,163,113
2016/9/30,141097,港北区,新羽町,49,227,137,90
2016/9/30,141097,港北区,新羽町,50,179,103,76
2016/9/30,141097,港北区,新羽町,51,231,134,97
2016/9/30,141097,港北区,新羽町,52,191,102,89
2016/9/30,141097,港北区,新羽町,53,171,92,79
2016/9/30,141097,港北区,新羽町,54,140,87,53
2016/9/30,141097,港北区,新羽町,55,142,91,51
2016/9/30,141097,港北区,新羽町,56,139,80,59
2016/9/30,141097,港北区,新羽町,57,129,75,54
2016/9/30,141097,港北区,新羽町,58,111,49,62
2016/9/30,141097,港北区,新羽町,59,95,49,46
2016/9/30,141097,港北区,新羽町,60,107,59,48
2016/9/30,141097,港北区,新羽町,61,100,54,46
2016/9/30,141097,港北区,新羽町,62,111,50,61
2016/9/30,141097,港北区,新羽町,63,100,55,45
2016/9/30,141097,港北区,新羽町,64,111,53,58
2016/9/30,141097,港北区,新羽町,65,116,57,59
2016/9/30,141097,港北区,新羽町,66,132,66,66
2016/9/30,141097,港北区,新羽町,67,142,77,65
2016/9/30,141097,港北区,新羽町,68,149,71,78
2016/9/30,141097,港北区,新羽町,69,150,80,70
2016/9/30,141097,港北区,新羽町,70,98,47,51
2016/9/30,141097,港北区,新羽町,71,92,46,46
2016/9/30,141097,港北区,新羽町,72,138,59,79
2016/9/30,141097,港北区,新羽町,73,143,63,80
2016/9/30,141097,港北区,新羽町,74,130,63,67
2016/9/30,141097,港北区,新羽町,75,129,62,67
2016/9/30,141097,港北区,新羽町,76,102,41,61
2016/9/30,141097,港北区,新羽町,77,78,35,43
2016/9/30,141097,港北区,新羽町,78,91,46,45
2016/9/30,141097,港北区,新羽町,79,79,38,41
2016/9/30,141097,港北区,新羽町,80,70,35,35
2016/9/30,141097,港北区,新羽町,81,65,32,33
2016/9/30,141097,港北区,新羽町,82,52,17,35
2016/9/30,141097,港北区,新羽町,83,49,16,33
2016/9/30,141097,港北区,新羽町,84,43,25,18
2016/9/30,141097,港北区,新羽町,85,49,15,34
2016/9/30,141097,港北区,新羽町,86,46,15,31
2016/9/30,141097,港北区,新羽町,87,27,14,13
2016/9/30,141097,港北区,新羽町,88,37,14,23
2016/9/30,141097,港北区,新羽町,89,23,8,15
2016/9/30,141097,港北区,新羽町,90,21,5,16
2016/9/30,141097,港北区,新羽町,91,17,5,12
2016/9/30,141097,港北区,新羽町,92,11,3,8
2016/9/30,141097,港北区,新羽町,93,7,3,4
2016/9/30,141097,港北区,新羽町,94,5,2,3
2016/9/30,141097,港北区,新羽町,95,9,2,7
2016/9/30,141097,港北区,新羽町,96,5,3,2
2016/9/30,141097,港北区,新羽町,97,4,0,4
2016/9/30,141097,港北区,新羽町,98,3,0,3
2016/9/30,141097,港北区,新羽町,99,1,0,1
2016/9/30,141097,港北区,新羽町,100,4,2,2
2016/9/30,141097,港北区,大曽根一丁目,合計,2161,1033,1128
2016/9/30,141097,港北区,大曽根一丁目,0,17,8,9
2016/9/30,141097,港北区,大曽根一丁目,1,11,4,7
2016/9/30,141097,港北区,大曽根一丁目,2,6,2,4
2016/9/30,141097,港北区,大曽根一丁目,3,12,6,6
2016/9/30,141097,港北区,大曽根一丁目,4,13,5,8
2016/9/30,141097,港北区,大曽根一丁目,5,11,5,6
2016/9/30,141097,港北区,大曽根一丁目,6,12,6,6
2016/9/30,141097,港北区,大曽根一丁目,7,10,3,7
2016/9/30,141097,港北区,大曽根一丁目,8,13,7,6
2016/9/30,141097,港北区,大曽根一丁目,9,12,5,7
2016/9/30,141097,港北区,大曽根一丁目,10,14,4,10
2016/9/30,141097,港北区,大曽根一丁目,11,17,14,3
2016/9/30,141097,港北区,大曽根一丁目,12,14,7,7
2016/9/30,141097,港北区,大曽根一丁目,13,13,7,6
2016/9/30,141097,港北区,大曽根一丁目,14,14,9,5
2016/9/30,141097,港北区,大曽根一丁目,15,13,7,6
2016/9/30,141097,港北区,大曽根一丁目,16,11,7,4
2016/9/30,141097,港北区,大曽根一丁目,17,8,4,4
2016/9/30,141097,港北区,大曽根一丁目,18,18,9,9
2016/9/30,141097,港北区,大曽根一丁目,19,15,8,7
2016/9/30,141097,港北区,大曽根一丁目,20,17,8,9
2016/9/30,141097,港北区,大曽根一丁目,21,11,5,6
2016/9/30,141097,港北区,大曽根一丁目,22,27,11,16
2016/9/30,141097,港北区,大曽根一丁目,23,34,14,20
2016/9/30,141097,港北区,大曽根一丁目,24,27,12,15
2016/9/30,141097,港北区,大曽根一丁目,25,20,7,13
2016/9/30,141097,港北区,大曽根一丁目,26,29,17,12
2016/9/30,141097,港北区,大曽根一丁目,27,23,10,13
2016/9/30,141097,港北区,大曽根一丁目,28,28,14,14
2016/9/30,141097,港北区,大曽根一丁目,29,33,15,18
2016/9/30,141097,港北区,大曽根一丁目,30,38,15,23
2016/9/30,141097,港北区,大曽根一丁目,31,44,22,22
2016/9/30,141097,港北区,大曽根一丁目,32,35,17,18
2016/9/30,141097,港北区,大曽根一丁目,33,42,25,17
2016/9/30,141097,港北区,大曽根一丁目,34,33,20,13
2016/9/30,141097,港北区,大曽根一丁目,35,31,11,20
2016/9/30,141097,港北区,大曽根一丁目,36,21,8,13
2016/9/30,141097,港北区,大曽根一丁目,37,28,13,15
2016/9/30,141097,港北区,大曽根一丁目,38,20,13,7
2016/9/30,141097,港北区,大曽根一丁目,39,33,14,19
2016/9/30,141097,港北区,大曽根一丁目,40,32,17,15
2016/9/30,141097,港北区,大曽根一丁目,41,26,13,13
2016/9/30,141097,港北区,大曽根一丁目,42,23,15,8
2016/9/30,141097,港北区,大曽根一丁目,43,34,22,12
2016/9/30,141097,港北区,大曽根一丁目,44,38,24,14
2016/9/30,141097,港北区,大曽根一丁目,45,44,16,28
2016/9/30,141097,港北区,大曽根一丁目,46,38,23,15
2016/9/30,141097,港北区,大曽根一丁目,47,46,16,30
2016/9/30,141097,港北区,大曽根一丁目,48,42,26,16
2016/9/30,141097,港北区,大曽根一丁目,49,35,20,15
2016/9/30,141097,港北区,大曽根一丁目,50,33,16,17
2016/9/30,141097,港北区,大曽根一丁目,51,34,21,13
2016/9/30,141097,港北区,大曽根一丁目,52,27,15,12
2016/9/30,141097,港北区,大曽根一丁目,53,30,18,12
2016/9/30,141097,港北区,大曽根一丁目,54,32,16,16
2016/9/30,141097,港北区,大曽根一丁目,55,25,10,15
2016/9/30,141097,港北区,大曽根一丁目,56,21,11,10
2016/9/30,141097,港北区,大曽根一丁目,57,32,13,19
2016/9/30,141097,港北区,大曽根一丁目,58,23,14,9
2016/9/30,141097,港北区,大曽根一丁目,59,22,11,11
2016/9/30,141097,港北区,大曽根一丁目,60,21,7,14
2016/9/30,141097,港北区,大曽根一丁目,61,27,11,16
2016/9/30,141097,港北区,大曽根一丁目,62,18,7,11
2016/9/30,141097,港北区,大曽根一丁目,63,31,14,17
2016/9/30,141097,港北区,大曽根一丁目,64,32,12,20
2016/9/30,141097,港北区,大曽根一丁目,65,32,19,13
2016/9/30,141097,港北区,大曽根一丁目,66,30,18,12
2016/9/30,141097,港北区,大曽根一丁目,67,32,20,12
2016/9/30,141097,港北区,大曽根一丁目,68,37,19,18
2016/9/30,141097,港北区,大曽根一丁目,69,19,9,10
2016/9/30,141097,港北区,大曽根一丁目,70,19,10,9
2016/9/30,141097,港北区,大曽根一丁目,71,13,4,9
2016/9/30,141097,港北区,大曽根一丁目,72,16,3,13
2016/9/30,141097,港北区,大曽根一丁目,73,23,11,12
2016/9/30,141097,港北区,大曽根一丁目,74,20,6,14
2016/9/30,141097,港北区,大曽根一丁目,75,27,12,15
2016/9/30,141097,港北区,大曽根一丁目,76,17,9,8
2016/9/30,141097,港北区,大曽根一丁目,77,12,5,7
2016/9/30,141097,港北区,大曽根一丁目,78,16,6,10
2016/9/30,141097,港北区,大曽根一丁目,79,27,13,14
2016/9/30,141097,港北区,大曽根一丁目,80,24,9,15
2016/9/30,141097,港北区,大曽根一丁目,81,25,8,17
2016/9/30,141097,港北区,大曽根一丁目,82,16,8,8
2016/9/30,141097,港北区,大曽根一丁目,83,29,10,19
2016/9/30,141097,港北区,大曽根一丁目,84,19,11,8
2016/9/30,141097,港北区,大曽根一丁目,85,16,8,8
2016/9/30,141097,港北区,大曽根一丁目,86,14,4,10
2016/9/30,141097,港北区,大曽根一丁目,87,15,4,11
2016/9/30,141097,港北区,大曽根一丁目,88,10,4,6
2016/9/30,141097,港北区,大曽根一丁目,89,10,6,4
2016/9/30,141097,港北区,大曽根一丁目,90,11,3,8
2016/9/30,141097,港北区,大曽根一丁目,91,10,2,8
2016/9/30,141097,港北区,大曽根一丁目,92,11,4,7
2016/9/30,141097,港北区,大曽根一丁目,93,4,0,4
2016/9/30,141097,港北区,大曽根一丁目,94,4,0,4
2016/9/30,141097,港北区,大曽根一丁目,95,4,1,3
2016/9/30,141097,港北区,大曽根一丁目,96,3,1,2
2016/9/30,141097,港北区,大曽根一丁目,97,1,0,1
2016/9/30,141097,港北区,大曽根一丁目,98,0,0,0
2016/9/30,141097,港北区,大曽根一丁目,99,0,0,0
2016/9/30,141097,港北区,大曽根一丁目,100,1,0,1
2016/9/30,141097,港北区,大曽根二丁目,合計,2924,1455,1469
2016/9/30,141097,港北区,大曽根二丁目,0,32,12,20
2016/9/30,141097,港北区,大曽根二丁目,1,29,20,9
2016/9/30,141097,港北区,大曽根二丁目,2,24,9,15
2016/9/30,141097,港北区,大曽根二丁目,3,27,18,9
2016/9/30,141097,港北区,大曽根二丁目,4,18,13,5
2016/9/30,141097,港北区,大曽根二丁目,5,19,9,10
2016/9/30,141097,港北区,大曽根二丁目,6,22,14,8
2016/9/30,141097,港北区,大曽根二丁目,7,24,12,12
2016/9/30,141097,港北区,大曽根二丁目,8,24,10,14
2016/9/30,141097,港北区,大曽根二丁目,9,15,8,7
2016/9/30,141097,港北区,大曽根二丁目,10,20,6,14
2016/9/30,141097,港北区,大曽根二丁目,11,19,9,10
2016/9/30,141097,港北区,大曽根二丁目,12,18,6,12
2016/9/30,141097,港北区,大曽根二丁目,13,13,6,7
2016/9/30,141097,港北区,大曽根二丁目,14,14,4,10
2016/9/30,141097,港北区,大曽根二丁目,15,24,13,11
2016/9/30,141097,港北区,大曽根二丁目,16,15,9,6
2016/9/30,141097,港北区,大曽根二丁目,17,19,13,6
2016/9/30,141097,港北区,大曽根二丁目,18,27,15,12
2016/9/30,141097,港北区,大曽根二丁目,19,19,10,9
2016/9/30,141097,港北区,大曽根二丁目,20,26,11,15
2016/9/30,141097,港北区,大曽根二丁目,21,33,17,16
2016/9/30,141097,港北区,大曽根二丁目,22,31,16,15
2016/9/30,141097,港北区,大曽根二丁目,23,27,12,15
2016/9/30,141097,港北区,大曽根二丁目,24,37,19,18
2016/9/30,141097,港北区,大曽根二丁目,25,34,20,14
2016/9/30,141097,港北区,大曽根二丁目,26,47,29,18
2016/9/30,141097,港北区,大曽根二丁目,27,40,22,18
2016/9/30,141097,港北区,大曽根二丁目,28,44,25,19
2016/9/30,141097,港北区,大曽根二丁目,29,41,17,24
2016/9/30,141097,港北区,大曽根二丁目,30,48,28,20
2016/9/30,141097,港北区,大曽根二丁目,31,47,29,18
2016/9/30,141097,港北区,大曽根二丁目,32,44,18,26
2016/9/30,141097,港北区,大曽根二丁目,33,51,27,24
2016/9/30,141097,港北区,大曽根二丁目,34,44,27,17
2016/9/30,141097,港北区,大曽根二丁目,35,44,21,23
2016/9/30,141097,港北区,大曽根二丁目,36,45,19,26
2016/9/30,141097,港北区,大曽根二丁目,37,41,19,22
2016/9/30,141097,港北区,大曽根二丁目,38,51,27,24
2016/9/30,141097,港北区,大曽根二丁目,39,45,22,23
2016/9/30,141097,港北区,大曽根二丁目,40,49,24,25
2016/9/30,141097,港北区,大曽根二丁目,41,44,25,19
2016/9/30,141097,港北区,大曽根二丁目,42,49,29,20
2016/9/30,141097,港北区,大曽根二丁目,43,40,24,16
2016/9/30,141097,港北区,大曽根二丁目,44,41,21,20
2016/9/30,141097,港北区,大曽根二丁目,45,43,24,19
2016/9/30,141097,港北区,大曽根二丁目,46,44,26,18
2016/9/30,141097,港北区,大曽根二丁目,47,36,22,14
2016/9/30,141097,港北区,大曽根二丁目,48,32,17,15
2016/9/30,141097,港北区,大曽根二丁目,49,46,27,19
2016/9/30,141097,港北区,大曽根二丁目,50,25,11,14
2016/9/30,141097,港北区,大曽根二丁目,51,39,19,20
2016/9/30,141097,港北区,大曽根二丁目,52,38,20,18
2016/9/30,141097,港北区,大曽根二丁目,53,42,23,19
2016/9/30,141097,港北区,大曽根二丁目,54,37,17,20
2016/9/30,141097,港北区,大曽根二丁目,55,42,18,24
2016/9/30,141097,港北区,大曽根二丁目,56,30,16,14
2016/9/30,141097,港北区,大曽根二丁目,57,32,18,14
2016/9/30,141097,港北区,大曽根二丁目,58,32,20,12
2016/9/30,141097,港北区,大曽根二丁目,59,34,15,19
2016/9/30,141097,港北区,大曽根二丁目,60,25,9,16
2016/9/30,141097,港北区,大曽根二丁目,61,24,12,12
2016/9/30,141097,港北区,大曽根二丁目,62,34,15,19
2016/9/30,141097,港北区,大曽根二丁目,63,26,11,15
2016/9/30,141097,港北区,大曽根二丁目,64,33,17,16
2016/9/30,141097,港北区,大曽根二丁目,65,53,27,26
2016/9/30,141097,港北区,大曽根二丁目,66,54,29,25
2016/9/30,141097,港北区,大曽根二丁目,67,53,29,24
2016/9/30,141097,港北区,大曽根二丁目,68,46,27,19
2016/9/30,141097,港北区,大曽根二丁目,69,40,19,21
2016/9/30,141097,港北区,大曽根二丁目,70,29,11,18
2016/9/30,141097,港北区,大曽根二丁目,71,34,15,19
2016/9/30,141097,港北区,大曽根二丁目,72,42,24,18
2016/9/30,141097,港北区,大曽根二丁目,73,28,17,11
2016/9/30,141097,港北区,大曽根二丁目,74,29,16,13
2016/9/30,141097,港北区,大曽根二丁目,75,28,12,16
2016/9/30,141097,港北区,大曽根二丁目,76,20,10,10
2016/9/30,141097,港北区,大曽根二丁目,77,19,7,12
2016/9/30,141097,港北区,大曽根二丁目,78,20,7,13
2016/9/30,141097,港北区,大曽根二丁目,79,20,3,17
2016/9/30,141097,港北区,大曽根二丁目,80,30,11,19
2016/9/30,141097,港北区,大曽根二丁目,81,16,5,11
2016/9/30,141097,港北区,大曽根二丁目,82,31,11,20
2016/9/30,141097,港北区,大曽根二丁目,83,14,5,9
2016/9/30,141097,港北区,大曽根二丁目,84,14,2,12
2016/9/30,141097,港北区,大曽根二丁目,85,18,5,13
2016/9/30,141097,港北区,大曽根二丁目,86,24,10,14
2016/9/30,141097,港北区,大曽根二丁目,87,20,6,14
2016/9/30,141097,港北区,大曽根二丁目,88,18,7,11
2016/9/30,141097,港北区,大曽根二丁目,89,12,4,8
2016/9/30,141097,港北区,大曽根二丁目,90,8,1,7
2016/9/30,141097,港北区,大曽根二丁目,91,10,3,7
2016/9/30,141097,港北区,大曽根二丁目,92,10,4,6
2016/9/30,141097,港北区,大曽根二丁目,93,6,2,4
2016/9/30,141097,港北区,大曽根二丁目,94,3,1,2
2016/9/30,141097,港北区,大曽根二丁目,95,6,3,3
2016/9/30,141097,港北区,大曽根二丁目,96,3,0,3
2016/9/30,141097,港北区,大曽根二丁目,97,1,0,1
2016/9/30,141097,港北区,大曽根二丁目,98,2,1,1
2016/9/30,141097,港北区,大曽根二丁目,99,0,0,0
2016/9/30,141097,港北区,大曽根二丁目,100,4,0,4
2016/9/30,141097,港北区,大曽根三丁目,合計,3274,1662,1612
2016/9/30,141097,港北区,大曽根三丁目,0,26,10,16
2016/9/30,141097,港北区,大曽根三丁目,1,37,22,15
2016/9/30,141097,港北区,大曽根三丁目,2,24,12,12
2016/9/30,141097,港北区,大曽根三丁目,3,31,14,17
2016/9/30,141097,港北区,大曽根三丁目,4,29,15,14
2016/9/30,141097,港北区,大曽根三丁目,5,22,11,11
2016/9/30,141097,港北区,大曽根三丁目,6,26,13,13
2016/9/30,141097,港北区,大曽根三丁目,7,34,17,17
2016/9/30,141097,港北区,大曽根三丁目,8,31,19,12
2016/9/30,141097,港北区,大曽根三丁目,9,20,15,5
2016/9/30,141097,港北区,大曽根三丁目,10,29,13,16
2016/9/30,141097,港北区,大曽根三丁目,11,38,17,21
2016/9/30,141097,港北区,大曽根三丁目,12,23,11,12
2016/9/30,141097,港北区,大曽根三丁目,13,39,24,15
2016/9/30,141097,港北区,大曽根三丁目,14,34,20,14
2016/9/30,141097,港北区,大曽根三丁目,15,43,26,17
2016/9/30,141097,港北区,大曽根三丁目,16,47,26,21
2016/9/30,141097,港北区,大曽根三丁目,17,35,18,17
2016/9/30,141097,港北区,大曽根三丁目,18,36,17,19
2016/9/30,141097,港北区,大曽根三丁目,19,33,14,19
2016/9/30,141097,港北区,大曽根三丁目,20,47,26,21
2016/9/30,141097,港北区,大曽根三丁目,21,29,15,14
2016/9/30,141097,港北区,大曽根三丁目,22,34,13,21
2016/9/30,141097,港北区,大曽根三丁目,23,42,21,21
2016/9/30,141097,港北区,大曽根三丁目,24,18,8,10
2016/9/30,141097,港北区,大曽根三丁目,25,35,21,14
2016/9/30,141097,港北区,大曽根三丁目,26,35,16,19
2016/9/30,141097,港北区,大曽根三丁目,27,44,15,29
2016/9/30,141097,港北区,大曽根三丁目,28,38,17,21
2016/9/30,141097,港北区,大曽根三丁目,29,41,21,20
2016/9/30,141097,港北区,大曽根三丁目,30,46,26,20
2016/9/30,141097,港北区,大曽根三丁目,31,37,20,17
2016/9/30,141097,港北区,大曽根三丁目,32,41,26,15
2016/9/30,141097,港北区,大曽根三丁目,33,46,27,19
2016/9/30,141097,港北区,大曽根三丁目,34,57,25,32
2016/9/30,141097,港北区,大曽根三丁目,35,47,23,24
2016/9/30,141097,港北区,大曽根三丁目,36,51,21,30
2016/9/30,141097,港北区,大曽根三丁目,37,56,32,24
2016/9/30,141097,港北区,大曽根三丁目,38,44,23,21
2016/9/30,141097,港北区,大曽根三丁目,39,46,24,22
2016/9/30,141097,港北区,大曽根三丁目,40,56,30,26
2016/9/30,141097,港北区,大曽根三丁目,41,48,22,26
2016/9/30,141097,港北区,大曽根三丁目,42,45,22,23
2016/9/30,141097,港北区,大曽根三丁目,43,63,29,34
2016/9/30,141097,港北区,大曽根三丁目,44,59,34,25
2016/9/30,141097,港北区,大曽根三丁目,45,61,31,30
2016/9/30,141097,港北区,大曽根三丁目,46,61,31,30
2016/9/30,141097,港北区,大曽根三丁目,47,67,35,32
2016/9/30,141097,港北区,大曽根三丁目,48,82,43,39
2016/9/30,141097,港北区,大曽根三丁目,49,84,49,35
2016/9/30,141097,港北区,大曽根三丁目,50,46,27,19
2016/9/30,141097,港北区,大曽根三丁目,51,72,38,34
2016/9/30,141097,港北区,大曽根三丁目,52,68,39,29
2016/9/30,141097,港北区,大曽根三丁目,53,54,26,28
2016/9/30,141097,港北区,大曽根三丁目,54,56,33,23
2016/9/30,141097,港北区,大曽根三丁目,55,55,24,31
2016/9/30,141097,港北区,大曽根三丁目,56,36,20,16
2016/9/30,141097,港北区,大曽根三丁目,57,47,31,16
2016/9/30,141097,港北区,大曽根三丁目,58,43,26,17
2016/9/30,141097,港北区,大曽根三丁目,59,27,16,11
2016/9/30,141097,港北区,大曽根三丁目,60,24,13,11
2016/9/30,141097,港北区,大曽根三丁目,61,25,13,12
2016/9/30,141097,港北区,大曽根三丁目,62,28,15,13
2016/9/30,141097,港北区,大曽根三丁目,63,33,20,13
2016/9/30,141097,港北区,大曽根三丁目,64,34,14,20
2016/9/30,141097,港北区,大曽根三丁目,65,25,12,13
2016/9/30,141097,港北区,大曽根三丁目,66,25,12,13
2016/9/30,141097,港北区,大曽根三丁目,67,28,13,15
2016/9/30,141097,港北区,大曽根三丁目,68,31,13,18
2016/9/30,141097,港北区,大曽根三丁目,69,31,19,12
2016/9/30,141097,港北区,大曽根三丁目,70,20,12,8
2016/9/30,141097,港北区,大曽根三丁目,71,22,10,12
2016/9/30,141097,港北区,大曽根三丁目,72,23,11,12
2016/9/30,141097,港北区,大曽根三丁目,73,15,4,11
2016/9/30,141097,港北区,大曽根三丁目,74,23,5,18
2016/9/30,141097,港北区,大曽根三丁目,75,15,8,7
2016/9/30,141097,港北区,大曽根三丁目,76,34,15,19
2016/9/30,141097,港北区,大曽根三丁目,77,20,8,12
2016/9/30,141097,港北区,大曽根三丁目,78,18,7,11
2016/9/30,141097,港北区,大曽根三丁目,79,19,6,13
2016/9/30,141097,港北区,大曽根三丁目,80,14,5,9
2016/9/30,141097,港北区,大曽根三丁目,81,33,16,17
2016/9/30,141097,港北区,大曽根三丁目,82,22,10,12
2016/9/30,141097,港北区,大曽根三丁目,83,7,1,6
2016/9/30,141097,港北区,大曽根三丁目,84,16,4,12
2016/9/30,141097,港北区,大曽根三丁目,85,21,11,10
2016/9/30,141097,港北区,大曽根三丁目,86,13,4,9
2016/9/30,141097,港北区,大曽根三丁目,87,11,4,7
2016/9/30,141097,港北区,大曽根三丁目,88,5,2,3
2016/9/30,141097,港北区,大曽根三丁目,89,7,1,6
2016/9/30,141097,港北区,大曽根三丁目,90,5,2,3
2016/9/30,141097,港北区,大曽根三丁目,91,8,2,6
2016/9/30,141097,港北区,大曽根三丁目,92,6,4,2
2016/9/30,141097,港北区,大曽根三丁目,93,6,4,2
2016/9/30,141097,港北区,大曽根三丁目,94,1,1,0
2016/9/30,141097,港北区,大曽根三丁目,95,1,0,1
2016/9/30,141097,港北区,大曽根三丁目,96,0,0,0
2016/9/30,141097,港北区,大曽根三丁目,97,1,1,0
2016/9/30,141097,港北区,大曽根三丁目,98,1,0,1
2016/9/30,141097,港北区,大曽根三丁目,99,0,0,0
2016/9/30,141097,港北区,大曽根三丁目,100,2,0,2
2016/9/30,141097,港北区,大曽根台,合計,2646,1315,1331
2016/9/30,141097,港北区,大曽根台,0,18,8,10
2016/9/30,141097,港北区,大曽根台,1,22,11,11
2016/9/30,141097,港北区,大曽根台,2,24,14,10
2016/9/30,141097,港北区,大曽根台,3,21,7,14
2016/9/30,141097,港北区,大曽根台,4,18,10,8
2016/9/30,141097,港北区,大曽根台,5,20,8,12
2016/9/30,141097,港北区,大曽根台,6,21,10,11
2016/9/30,141097,港北区,大曽根台,7,17,8,9
2016/9/30,141097,港北区,大曽根台,8,19,10,9
2016/9/30,141097,港北区,大曽根台,9,16,12,4
2016/9/30,141097,港北区,大曽根台,10,21,10,11
2016/9/30,141097,港北区,大曽根台,11,14,7,7
2016/9/30,141097,港北区,大曽根台,12,14,10,4
2016/9/30,141097,港北区,大曽根台,13,25,14,11
2016/9/30,141097,港北区,大曽根台,14,21,12,9
2016/9/30,141097,港北区,大曽根台,15,18,12,6
2016/9/30,141097,港北区,大曽根台,16,21,10,11
2016/9/30,141097,港北区,大曽根台,17,17,8,9
2016/9/30,141097,港北区,大曽根台,18,20,11,9
2016/9/30,141097,港北区,大曽根台,19,17,9,8
2016/9/30,141097,港北区,大曽根台,20,18,9,9
2016/9/30,141097,港北区,大曽根台,21,34,16,18
2016/9/30,141097,港北区,大曽根台,22,20,13,7
2016/9/30,141097,港北区,大曽根台,23,33,17,16
2016/9/30,141097,港北区,大曽根台,24,36,15,21
2016/9/30,141097,港北区,大曽根台,25,33,16,17
2016/9/30,141097,港北区,大曽根台,26,23,15,8
2016/9/30,141097,港北区,大曽根台,27,29,10,19
2016/9/30,141097,港北区,大曽根台,28,44,21,23
2016/9/30,141097,港北区,大曽根台,29,47,23,24
2016/9/30,141097,港北区,大曽根台,30,38,21,17
2016/9/30,141097,港北区,大曽根台,31,35,19,16
2016/9/30,141097,港北区,大曽根台,32,38,21,17
2016/9/30,141097,港北区,大曽根台,33,41,24,17
2016/9/30,141097,港北区,大曽根台,34,42,27,15
2016/9/30,141097,港北区,大曽根台,35,39,22,17
2016/9/30,141097,港北区,大曽根台,36,37,16,21
2016/9/30,141097,港北区,大曽根台,37,45,21,24
2016/9/30,141097,港北区,大曽根台,38,45,21,24
2016/9/30,141097,港北区,大曽根台,39,30,14,16
2016/9/30,141097,港北区,大曽根台,40,44,25,19
2016/9/30,141097,港北区,大曽根台,41,42,21,21
2016/9/30,141097,港北区,大曽根台,42,58,28,30
2016/9/30,141097,港北区,大曽根台,43,41,18,23
2016/9/30,141097,港北区,大曽根台,44,46,21,25
2016/9/30,141097,港北区,大曽根台,45,45,27,18
2016/9/30,141097,港北区,大曽根台,46,36,21,15
2016/9/30,141097,港北区,大曽根台,47,39,25,14
2016/9/30,141097,港北区,大曽根台,48,45,26,19
2016/9/30,141097,港北区,大曽根台,49,38,21,17
2016/9/30,141097,港北区,大曽根台,50,44,22,22
2016/9/30,141097,港北区,大曽根台,51,31,15,16
2016/9/30,141097,港北区,大曽根台,52,30,19,11
2016/9/30,141097,港北区,大曽根台,53,36,13,23
2016/9/30,141097,港北区,大曽根台,54,28,16,12
2016/9/30,141097,港北区,大曽根台,55,26,19,7
2016/9/30,141097,港北区,大曽根台,56,31,12,19
2016/9/30,141097,港北区,大曽根台,57,39,21,18
2016/9/30,141097,港北区,大曽根台,58,32,17,15
2016/9/30,141097,港北区,大曽根台,59,24,12,12
2016/9/30,141097,港北区,大曽根台,60,29,12,17
2016/9/30,141097,港北区,大曽根台,61,25,13,12
2016/9/30,141097,港北区,大曽根台,62,29,13,16
2016/9/30,141097,港北区,大曽根台,63,25,17,8
2016/9/30,141097,港北区,大曽根台,64,32,17,15
2016/9/30,141097,港北区,大曽根台,65,35,13,22
2016/9/30,141097,港北区,大曽根台,66,33,19,14
2016/9/30,141097,港北区,大曽根台,67,33,15,18
2016/9/30,141097,港北区,大曽根台,68,39,16,23
2016/9/30,141097,港北区,大曽根台,69,40,23,17
2016/9/30,141097,港北区,大曽根台,70,30,14,16
2016/9/30,141097,港北区,大曽根台,71,20,12,8
2016/9/30,141097,港北区,大曽根台,72,26,9,17
2016/9/30,141097,港北区,大曽根台,73,24,13,11
2016/9/30,141097,港北区,大曽根台,74,23,15,8
2016/9/30,141097,港北区,大曽根台,75,25,10,15
2016/9/30,141097,港北区,大曽根台,76,31,14,17
2016/9/30,141097,港北区,大曽根台,77,21,8,13
2016/9/30,141097,港北区,大曽根台,78,32,11,21
2016/9/30,141097,港北区,大曽根台,79,20,4,16
2016/9/30,141097,港北区,大曽根台,80,22,11,11
2016/9/30,141097,港北区,大曽根台,81,28,9,19
2016/9/30,141097,港北区,大曽根台,82,24,11,13
2016/9/30,141097,港北区,大曽根台,83,17,6,11
2016/9/30,141097,港北区,大曽根台,84,15,7,8
2016/9/30,141097,港北区,大曽根台,85,16,8,8
2016/9/30,141097,港北区,大曽根台,86,17,8,9
2016/9/30,141097,港北区,大曽根台,87,16,4,12
2016/9/30,141097,港北区,大曽根台,88,12,5,7
2016/9/30,141097,港北区,大曽根台,89,16,4,12
2016/9/30,141097,港北区,大曽根台,90,7,4,3
2016/9/30,141097,港北区,大曽根台,91,10,3,7
2016/9/30,141097,港北区,大曽根台,92,10,2,8
2016/9/30,141097,港北区,大曽根台,93,4,2,2
2016/9/30,141097,港北区,大曽根台,94,3,0,3
2016/9/30,141097,港北区,大曽根台,95,3,1,2
2016/9/30,141097,港北区,大曽根台,96,5,0,5
2016/9/30,141097,港北区,大曽根台,97,1,0,1
2016/9/30,141097,港北区,大曽根台,98,1,1,0
2016/9/30,141097,港北区,大曽根台,99,0,0,0
2016/9/30,141097,港北区,大曽根台,100,1,0,1
2016/9/30,141097,港北区,樽町一丁目,合計,4300,2143,2157
2016/9/30,141097,港北区,樽町一丁目,0,70,36,34
2016/9/30,141097,港北区,樽町一丁目,1,67,38,29
2016/9/30,141097,港北区,樽町一丁目,2,45,18,27
2016/9/30,141097,港北区,樽町一丁目,3,56,26,30
2016/9/30,141097,港北区,樽町一丁目,4,31,19,12
2016/9/30,141097,港北区,樽町一丁目,5,49,19,30
2016/9/30,141097,港北区,樽町一丁目,6,30,17,13
2016/9/30,141097,港北区,樽町一丁目,7,24,7,17
2016/9/30,141097,港北区,樽町一丁目,8,37,17,20
2016/9/30,141097,港北区,樽町一丁目,9,20,8,12
2016/9/30,141097,港北区,樽町一丁目,10,24,18,6
2016/9/30,141097,港北区,樽町一丁目,11,20,9,11
2016/9/30,141097,港北区,樽町一丁目,12,28,17,11
2016/9/30,141097,港北区,樽町一丁目,13,30,10,20
2016/9/30,141097,港北区,樽町一丁目,14,32,14,18
2016/9/30,141097,港北区,樽町一丁目,15,29,17,12
2016/9/30,141097,港北区,樽町一丁目,16,28,17,11
2016/9/30,141097,港北区,樽町一丁目,17,38,15,23
2016/9/30,141097,港北区,樽町一丁目,18,29,11,18
2016/9/30,141097,港北区,樽町一丁目,19,39,22,17
2016/9/30,141097,港北区,樽町一丁目,20,46,28,18
2016/9/30,141097,港北区,樽町一丁目,21,40,19,21
2016/9/30,141097,港北区,樽町一丁目,22,50,19,31
2016/9/30,141097,港北区,樽町一丁目,23,50,24,26
2016/9/30,141097,港北区,樽町一丁目,24,49,23,26
2016/9/30,141097,港北区,樽町一丁目,25,64,27,37
2016/9/30,141097,港北区,樽町一丁目,26,54,30,24
2016/9/30,141097,港北区,樽町一丁目,27,75,32,43
2016/9/30,141097,港北区,樽町一丁目,28,85,48,37
2016/9/30,141097,港北区,樽町一丁目,29,85,47,38
2016/9/30,141097,港北区,樽町一丁目,30,75,31,44
2016/9/30,141097,港北区,樽町一丁目,31,110,55,55
2016/9/30,141097,港北区,樽町一丁目,32,103,49,54
2016/9/30,141097,港北区,樽町一丁目,33,109,49,60
2016/9/30,141097,港北区,樽町一丁目,34,92,55,37
2016/9/30,141097,港北区,樽町一丁目,35,91,53,38
2016/9/30,141097,港北区,樽町一丁目,36,82,49,33
2016/9/30,141097,港北区,樽町一丁目,37,85,43,42
2016/9/30,141097,港北区,樽町一丁目,38,71,34,37
2016/9/30,141097,港北区,樽町一丁目,39,80,36,44
2016/9/30,141097,港北区,樽町一丁目,40,74,41,33
2016/9/30,141097,港北区,樽町一丁目,41,74,32,42
2016/9/30,141097,港北区,樽町一丁目,42,75,37,38
2016/9/30,141097,港北区,樽町一丁目,43,64,36,28
2016/9/30,141097,港北区,樽町一丁目,44,59,32,27
2016/9/30,141097,港北区,樽町一丁目,45,72,38,34
2016/9/30,141097,港北区,樽町一丁目,46,81,38,43
2016/9/30,141097,港北区,樽町一丁目,47,83,44,39
2016/9/30,141097,港北区,樽町一丁目,48,65,36,29
2016/9/30,141097,港北区,樽町一丁目,49,70,42,28
2016/9/30,141097,港北区,樽町一丁目,50,61,28,33
2016/9/30,141097,港北区,樽町一丁目,51,55,31,24
2016/9/30,141097,港北区,樽町一丁目,52,61,31,30
2016/9/30,141097,港北区,樽町一丁目,53,73,37,36
2016/9/30,141097,港北区,樽町一丁目,54,66,36,30
2016/9/30,141097,港北区,樽町一丁目,55,53,26,27
2016/9/30,141097,港北区,樽町一丁目,56,62,32,30
2016/9/30,141097,港北区,樽町一丁目,57,56,28,28
2016/9/30,141097,港北区,樽町一丁目,58,51,22,29
2016/9/30,141097,港北区,樽町一丁目,59,50,31,19
2016/9/30,141097,港北区,樽町一丁目,60,45,21,24
2016/9/30,141097,港北区,樽町一丁目,61,29,17,12
2016/9/30,141097,港北区,樽町一丁目,62,32,16,16
2016/9/30,141097,港北区,樽町一丁目,63,41,28,13
2016/9/30,141097,港北区,樽町一丁目,64,44,23,21
2016/9/30,141097,港北区,樽町一丁目,65,42,20,22
2016/9/30,141097,港北区,樽町一丁目,66,30,14,16
2016/9/30,141097,港北区,樽町一丁目,67,54,30,24
2016/9/30,141097,港北区,樽町一丁目,68,48,22,26
2016/9/30,141097,港北区,樽町一丁目,69,41,22,19
2016/9/30,141097,港北区,樽町一丁目,70,18,7,11
2016/9/30,141097,港北区,樽町一丁目,71,18,7,11
2016/9/30,141097,港北区,樽町一丁目,72,24,13,11
2016/9/30,141097,港北区,樽町一丁目,73,37,13,24
2016/9/30,141097,港北区,樽町一丁目,74,34,14,20
2016/9/30,141097,港北区,樽町一丁目,75,18,8,10
2016/9/30,141097,港北区,樽町一丁目,76,27,14,13
2016/9/30,141097,港北区,樽町一丁目,77,23,10,13
2016/9/30,141097,港北区,樽町一丁目,78,21,10,11
2016/9/30,141097,港北区,樽町一丁目,79,20,8,12
2016/9/30,141097,港北区,樽町一丁目,80,15,5,10
2016/9/30,141097,港北区,樽町一丁目,81,20,5,15
2016/9/30,141097,港北区,樽町一丁目,82,8,5,3
2016/9/30,141097,港北区,樽町一丁目,83,15,7,8
2016/9/30,141097,港北区,樽町一丁目,84,10,5,5
2016/9/30,141097,港北区,樽町一丁目,85,15,4,11
2016/9/30,141097,港北区,樽町一丁目,86,9,6,3
2016/9/30,141097,港北区,樽町一丁目,87,3,0,3
2016/9/30,141097,港北区,樽町一丁目,88,6,2,4
2016/9/30,141097,港北区,樽町一丁目,89,2,0,2
2016/9/30,141097,港北区,樽町一丁目,90,4,1,3
2016/9/30,141097,港北区,樽町一丁目,91,3,1,2
2016/9/30,141097,港北区,樽町一丁目,92,4,0,4
2016/9/30,141097,港北区,樽町一丁目,93,3,1,2
2016/9/30,141097,港北区,樽町一丁目,94,3,0,3
2016/9/30,141097,港北区,樽町一丁目,95,1,0,1
2016/9/30,141097,港北区,樽町一丁目,96,3,0,3
2016/9/30,141097,港北区,樽町一丁目,97,1,0,1
2016/9/30,141097,港北区,樽町一丁目,98,1,0,1
2016/9/30,141097,港北区,樽町一丁目,99,0,0,0
2016/9/30,141097,港北区,樽町一丁目,100,1,0,1
2016/9/30,141097,港北区,樽町二丁目,合計,4446,2216,2230
2016/9/30,141097,港北区,樽町二丁目,0,70,35,35
2016/9/30,141097,港北区,樽町二丁目,1,78,41,37
2016/9/30,141097,港北区,樽町二丁目,2,79,39,40
2016/9/30,141097,港北区,樽町二丁目,3,48,22,26
2016/9/30,141097,港北区,樽町二丁目,4,57,25,32
2016/9/30,141097,港北区,樽町二丁目,5,48,28,20
2016/9/30,141097,港北区,樽町二丁目,6,29,14,15
2016/9/30,141097,港北区,樽町二丁目,7,26,11,15
2016/9/30,141097,港北区,樽町二丁目,8,30,18,12
2016/9/30,141097,港北区,樽町二丁目,9,34,17,17
2016/9/30,141097,港北区,樽町二丁目,10,29,16,13
2016/9/30,141097,港北区,樽町二丁目,11,26,12,14
2016/9/30,141097,港北区,樽町二丁目,12,30,14,16
2016/9/30,141097,港北区,樽町二丁目,13,27,15,12
2016/9/30,141097,港北区,樽町二丁目,14,29,16,13
2016/9/30,141097,港北区,樽町二丁目,15,22,11,11
2016/9/30,141097,港北区,樽町二丁目,16,18,11,7
2016/9/30,141097,港北区,樽町二丁目,17,28,12,16
2016/9/30,141097,港北区,樽町二丁目,18,24,7,17
2016/9/30,141097,港北区,樽町二丁目,19,21,14,7
2016/9/30,141097,港北区,樽町二丁目,20,29,20,9
2016/9/30,141097,港北区,樽町二丁目,21,32,16,16
2016/9/30,141097,港北区,樽町二丁目,22,39,25,14
2016/9/30,141097,港北区,樽町二丁目,23,42,17,25
2016/9/30,141097,港北区,樽町二丁目,24,49,25,24
2016/9/30,141097,港北区,樽町二丁目,25,54,28,26
2016/9/30,141097,港北区,樽町二丁目,26,59,29,30
2016/9/30,141097,港北区,樽町二丁目,27,65,28,37
2016/9/30,141097,港北区,樽町二丁目,28,55,28,27
2016/9/30,141097,港北区,樽町二丁目,29,70,30,40
2016/9/30,141097,港北区,樽町二丁目,30,89,39,50
2016/9/30,141097,港北区,樽町二丁目,31,100,44,56
2016/9/30,141097,港北区,樽町二丁目,32,108,54,54
2016/9/30,141097,港北区,樽町二丁目,33,98,47,51
2016/9/30,141097,港北区,樽町二丁目,34,90,41,49
2016/9/30,141097,港北区,樽町二丁目,35,127,61,66
2016/9/30,141097,港北区,樽町二丁目,36,97,53,44
2016/9/30,141097,港北区,樽町二丁目,37,106,57,49
2016/9/30,141097,港北区,樽町二丁目,38,102,60,42
2016/9/30,141097,港北区,樽町二丁目,39,101,55,46
2016/9/30,141097,港北区,樽町二丁目,40,96,49,47
2016/9/30,141097,港北区,樽町二丁目,41,93,51,42
2016/9/30,141097,港北区,樽町二丁目,42,77,44,33
2016/9/30,141097,港北区,樽町二丁目,43,110,61,49
2016/9/30,141097,港北区,樽町二丁目,44,87,47,40
2016/9/30,141097,港北区,樽町二丁目,45,90,46,44
2016/9/30,141097,港北区,樽町二丁目,46,85,52,33
2016/9/30,141097,港北区,樽町二丁目,47,80,37,43
2016/9/30,141097,港北区,樽町二丁目,48,65,36,29
2016/9/30,141097,港北区,樽町二丁目,49,61,28,33
2016/9/30,141097,港北区,樽町二丁目,50,51,28,23
2016/9/30,141097,港北区,樽町二丁目,51,64,35,29
2016/9/30,141097,港北区,樽町二丁目,52,51,21,30
2016/9/30,141097,港北区,樽町二丁目,53,61,37,24
2016/9/30,141097,港北区,樽町二丁目,54,38,21,17
2016/9/30,141097,港北区,樽町二丁目,55,41,24,17
2016/9/30,141097,港北区,樽町二丁目,56,50,25,25
2016/9/30,141097,港北区,樽町二丁目,57,42,21,21
2016/9/30,141097,港北区,樽町二丁目,58,37,17,20
2016/9/30,141097,港北区,樽町二丁目,59,40,17,23
2016/9/30,141097,港北区,樽町二丁目,60,41,22,19
2016/9/30,141097,港北区,樽町二丁目,61,47,22,25
2016/9/30,141097,港北区,樽町二丁目,62,37,20,17
2016/9/30,141097,港北区,樽町二丁目,63,46,25,21
2016/9/30,141097,港北区,樽町二丁目,64,46,23,23
2016/9/30,141097,港北区,樽町二丁目,65,35,15,20
2016/9/30,141097,港北区,樽町二丁目,66,57,31,26
2016/9/30,141097,港北区,樽町二丁目,67,53,24,29
2016/9/30,141097,港北区,樽町二丁目,68,49,22,27
2016/9/30,141097,港北区,樽町二丁目,69,35,19,16
2016/9/30,141097,港北区,樽町二丁目,70,32,15,17
2016/9/30,141097,港北区,樽町二丁目,71,29,14,15
2016/9/30,141097,港北区,樽町二丁目,72,33,14,19
2016/9/30,141097,港北区,樽町二丁目,73,28,13,15
2016/9/30,141097,港北区,樽町二丁目,74,32,13,19
2016/9/30,141097,港北区,樽町二丁目,75,25,11,14
2016/9/30,141097,港北区,樽町二丁目,76,38,17,21
2016/9/30,141097,港北区,樽町二丁目,77,21,9,12
2016/9/30,141097,港北区,樽町二丁目,78,21,5,16
2016/9/30,141097,港北区,樽町二丁目,79,19,5,14
2016/9/30,141097,港北区,樽町二丁目,80,15,7,8
2016/9/30,141097,港北区,樽町二丁目,81,17,7,10
2016/9/30,141097,港北区,樽町二丁目,82,16,5,11
2016/9/30,141097,港北区,樽町二丁目,83,14,3,11
2016/9/30,141097,港北区,樽町二丁目,84,12,6,6
2016/9/30,141097,港北区,樽町二丁目,85,15,7,8
2016/9/30,141097,港北区,樽町二丁目,86,11,3,8
2016/9/30,141097,港北区,樽町二丁目,87,7,1,6
2016/9/30,141097,港北区,樽町二丁目,88,9,3,6
2016/9/30,141097,港北区,樽町二丁目,89,3,0,3
2016/9/30,141097,港北区,樽町二丁目,90,6,1,5
2016/9/30,141097,港北区,樽町二丁目,91,5,2,3
2016/9/30,141097,港北区,樽町二丁目,92,0,0,0
2016/9/30,141097,港北区,樽町二丁目,93,3,0,3
2016/9/30,141097,港北区,樽町二丁目,94,2,0,2
2016/9/30,141097,港北区,樽町二丁目,95,1,0,1
2016/9/30,141097,港北区,樽町二丁目,96,1,0,1
2016/9/30,141097,港北区,樽町二丁目,97,1,0,1
2016/9/30,141097,港北区,樽町二丁目,98,0,0,0
2016/9/30,141097,港北区,樽町二丁目,99,0,0,0
2016/9/30,141097,港北区,樽町二丁目,100,0,0,0
2016/9/30,141097,港北区,樽町三丁目,合計,5518,2771,2747
2016/9/30,141097,港北区,樽町三丁目,0,80,37,43
2016/9/30,141097,港北区,樽町三丁目,1,101,54,47
2016/9/30,141097,港北区,樽町三丁目,2,113,61,52
2016/9/30,141097,港北区,樽町三丁目,3,99,50,49
2016/9/30,141097,港北区,樽町三丁目,4,93,41,52
2016/9/30,141097,港北区,樽町三丁目,5,102,46,56
2016/9/30,141097,港北区,樽町三丁目,6,86,46,40
2016/9/30,141097,港北区,樽町三丁目,7,67,35,32
2016/9/30,141097,港北区,樽町三丁目,8,75,41,34
2016/9/30,141097,港北区,樽町三丁目,9,61,30,31
2016/9/30,141097,港北区,樽町三丁目,10,57,37,20
2016/9/30,141097,港北区,樽町三丁目,11,53,25,28
2016/9/30,141097,港北区,樽町三丁目,12,58,34,24
2016/9/30,141097,港北区,樽町三丁目,13,47,18,29
2016/9/30,141097,港北区,樽町三丁目,14,60,28,32
2016/9/30,141097,港北区,樽町三丁目,15,52,35,17
2016/9/30,141097,港北区,樽町三丁目,16,52,19,33
2016/9/30,141097,港北区,樽町三丁目,17,54,28,26
2016/9/30,141097,港北区,樽町三丁目,18,54,29,25
2016/9/30,141097,港北区,樽町三丁目,19,59,29,30
2016/9/30,141097,港北区,樽町三丁目,20,38,23,15
2016/9/30,141097,港北区,樽町三丁目,21,66,30,36
2016/9/30,141097,港北区,樽町三丁目,22,50,25,25
2016/9/30,141097,港北区,樽町三丁目,23,38,17,21
2016/9/30,141097,港北区,樽町三丁目,24,49,23,26
2016/9/30,141097,港北区,樽町三丁目,25,42,22,20
2016/9/30,141097,港北区,樽町三丁目,26,40,17,23
2016/9/30,141097,港北区,樽町三丁目,27,40,18,22
2016/9/30,141097,港北区,樽町三丁目,28,63,25,38
2016/9/30,141097,港北区,樽町三丁目,29,45,23,22
2016/9/30,141097,港北区,樽町三丁目,30,65,34,31
2016/9/30,141097,港北区,樽町三丁目,31,77,31,46
2016/9/30,141097,港北区,樽町三丁目,32,82,38,44
2016/9/30,141097,港北区,樽町三丁目,33,98,47,51
2016/9/30,141097,港北区,樽町三丁目,34,116,55,61
2016/9/30,141097,港北区,樽町三丁目,35,136,73,63
2016/9/30,141097,港北区,樽町三丁目,36,138,67,71
2016/9/30,141097,港北区,樽町三丁目,37,128,65,63
2016/9/30,141097,港北区,樽町三丁目,38,145,77,68
2016/9/30,141097,港北区,樽町三丁目,39,121,65,56
2016/9/30,141097,港北区,樽町三丁目,40,128,67,61
2016/9/30,141097,港北区,樽町三丁目,41,102,50,52
2016/9/30,141097,港北区,樽町三丁目,42,114,64,50
2016/9/30,141097,港北区,樽町三丁目,43,128,76,52
2016/9/30,141097,港北区,樽町三丁目,44,108,44,64
2016/9/30,141097,港北区,樽町三丁目,45,106,55,51
2016/9/30,141097,港北区,樽町三丁目,46,109,61,48
2016/9/30,141097,港北区,樽町三丁目,47,90,45,45
2016/9/30,141097,港北区,樽町三丁目,48,100,53,47
2016/9/30,141097,港北区,樽町三丁目,49,117,58,59
2016/9/30,141097,港北区,樽町三丁目,50,92,49,43
2016/9/30,141097,港北区,樽町三丁目,51,90,44,46
2016/9/30,141097,港北区,樽町三丁目,52,95,46,49
2016/9/30,141097,港北区,樽町三丁目,53,92,55,37
2016/9/30,141097,港北区,樽町三丁目,54,70,42,28
2016/9/30,141097,港北区,樽町三丁目,55,71,35,36
2016/9/30,141097,港北区,樽町三丁目,56,54,34,20
2016/9/30,141097,港北区,樽町三丁目,57,54,27,27
2016/9/30,141097,港北区,樽町三丁目,58,42,21,21
2016/9/30,141097,港北区,樽町三丁目,59,44,18,26
2016/9/30,141097,港北区,樽町三丁目,60,40,22,18
2016/9/30,141097,港北区,樽町三丁目,61,51,25,26
2016/9/30,141097,港北区,樽町三丁目,62,37,21,16
2016/9/30,141097,港北区,樽町三丁目,63,43,16,27
2016/9/30,141097,港北区,樽町三丁目,64,38,15,23
2016/9/30,141097,港北区,樽町三丁目,65,42,20,22
2016/9/30,141097,港北区,樽町三丁目,66,45,27,18
2016/9/30,141097,港北区,樽町三丁目,67,48,25,23
2016/9/30,141097,港北区,樽町三丁目,68,42,23,19
2016/9/30,141097,港北区,樽町三丁目,69,36,15,21
2016/9/30,141097,港北区,樽町三丁目,70,25,9,16
2016/9/30,141097,港北区,樽町三丁目,71,23,10,13
2016/9/30,141097,港北区,樽町三丁目,72,26,12,14
2016/9/30,141097,港北区,樽町三丁目,73,21,7,14
2016/9/30,141097,港北区,樽町三丁目,74,20,10,10
2016/9/30,141097,港北区,樽町三丁目,75,12,5,7
2016/9/30,141097,港北区,樽町三丁目,76,18,6,12
2016/9/30,141097,港北区,樽町三丁目,77,11,4,7
2016/9/30,141097,港北区,樽町三丁目,78,11,8,3
2016/9/30,141097,港北区,樽町三丁目,79,9,6,3
2016/9/30,141097,港北区,樽町三丁目,80,6,5,1
2016/9/30,141097,港北区,樽町三丁目,81,12,4,8
2016/9/30,141097,港北区,樽町三丁目,82,13,3,10
2016/9/30,141097,港北区,樽町三丁目,83,11,3,8
2016/9/30,141097,港北区,樽町三丁目,84,11,4,7
2016/9/30,141097,港北区,樽町三丁目,85,11,4,7
2016/9/30,141097,港北区,樽町三丁目,86,9,3,6
2016/9/30,141097,港北区,樽町三丁目,87,8,5,3
2016/9/30,141097,港北区,樽町三丁目,88,9,5,4
2016/9/30,141097,港北区,樽町三丁目,89,3,0,3
2016/9/30,141097,港北区,樽町三丁目,90,7,3,4
2016/9/30,141097,港北区,樽町三丁目,91,4,1,3
2016/9/30,141097,港北区,樽町三丁目,92,2,0,2
2016/9/30,141097,港北区,樽町三丁目,93,4,1,3
2016/9/30,141097,港北区,樽町三丁目,94,3,1,2
2016/9/30,141097,港北区,樽町三丁目,95,0,0,0
2016/9/30,141097,港北区,樽町三丁目,96,0,0,0
2016/9/30,141097,港北区,樽町三丁目,97,0,0,0
2016/9/30,141097,港北区,樽町三丁目,98,0,0,0
2016/9/30,141097,港北区,樽町三丁目,99,0,0,0
2016/9/30,141097,港北区,樽町三丁目,100,1,1,0
2016/9/30,141097,港北区,樽町四丁目,合計,3216,1701,1515
2016/9/30,141097,港北区,樽町四丁目,0,59,33,26
2016/9/30,141097,港北区,樽町四丁目,1,43,24,19
2016/9/30,141097,港北区,樽町四丁目,2,48,23,25
2016/9/30,141097,港北区,樽町四丁目,3,50,24,26
2016/9/30,141097,港北区,樽町四丁目,4,43,26,17
2016/9/30,141097,港北区,樽町四丁目,5,25,11,14
2016/9/30,141097,港北区,樽町四丁目,6,40,15,25
2016/9/30,141097,港北区,樽町四丁目,7,26,14,12
2016/9/30,141097,港北区,樽町四丁目,8,19,8,11
2016/9/30,141097,港北区,樽町四丁目,9,37,21,16
2016/9/30,141097,港北区,樽町四丁目,10,27,16,11
2016/9/30,141097,港北区,樽町四丁目,11,21,9,12
2016/9/30,141097,港北区,樽町四丁目,12,23,12,11
2016/9/30,141097,港北区,樽町四丁目,13,26,15,11
2016/9/30,141097,港北区,樽町四丁目,14,32,16,16
2016/9/30,141097,港北区,樽町四丁目,15,24,14,10
2016/9/30,141097,港北区,樽町四丁目,16,35,13,22
2016/9/30,141097,港北区,樽町四丁目,17,35,17,18
2016/9/30,141097,港北区,樽町四丁目,18,39,25,14
2016/9/30,141097,港北区,樽町四丁目,19,21,9,12
2016/9/30,141097,港北区,樽町四丁目,20,38,18,20
2016/9/30,141097,港北区,樽町四丁目,21,32,19,13
2016/9/30,141097,港北区,樽町四丁目,22,35,23,12
2016/9/30,141097,港北区,樽町四丁目,23,40,21,19
2016/9/30,141097,港北区,樽町四丁目,24,62,25,37
2016/9/30,141097,港北区,樽町四丁目,25,47,24,23
2016/9/30,141097,港北区,樽町四丁目,26,57,27,30
2016/9/30,141097,港北区,樽町四丁目,27,53,32,21
2016/9/30,141097,港北区,樽町四丁目,28,62,30,32
2016/9/30,141097,港北区,樽町四丁目,29,62,34,28
2016/9/30,141097,港北区,樽町四丁目,30,45,24,21
2016/9/30,141097,港北区,樽町四丁目,31,59,26,33
2016/9/30,141097,港北区,樽町四丁目,32,59,34,25
2016/9/30,141097,港北区,樽町四丁目,33,78,50,28
2016/9/30,141097,港北区,樽町四丁目,34,73,34,39
2016/9/30,141097,港北区,樽町四丁目,35,64,35,29
2016/9/30,141097,港北区,樽町四丁目,36,81,50,31
2016/9/30,141097,港北区,樽町四丁目,37,75,40,35
2016/9/30,141097,港北区,樽町四丁目,38,64,36,28
2016/9/30,141097,港北区,樽町四丁目,39,69,41,28
2016/9/30,141097,港北区,樽町四丁目,40,66,36,30
2016/9/30,141097,港北区,樽町四丁目,41,51,29,22
2016/9/30,141097,港北区,樽町四丁目,42,73,45,28
2016/9/30,141097,港北区,樽町四丁目,43,59,37,22
2016/9/30,141097,港北区,樽町四丁目,44,68,38,30
2016/9/30,141097,港北区,樽町四丁目,45,54,25,29
2016/9/30,141097,港北区,樽町四丁目,46,63,34,29
2016/9/30,141097,港北区,樽町四丁目,47,53,31,22
2016/9/30,141097,港北区,樽町四丁目,48,53,24,29
2016/9/30,141097,港北区,樽町四丁目,49,60,32,28
2016/9/30,141097,港北区,樽町四丁目,50,36,25,11
2016/9/30,141097,港北区,樽町四丁目,51,52,30,22
2016/9/30,141097,港北区,樽町四丁目,52,36,23,13
2016/9/30,141097,港北区,樽町四丁目,53,29,15,14
2016/9/30,141097,港北区,樽町四丁目,54,34,18,16
2016/9/30,141097,港北区,樽町四丁目,55,31,16,15
2016/9/30,141097,港北区,樽町四丁目,56,25,15,10
2016/9/30,141097,港北区,樽町四丁目,57,26,14,12
2016/9/30,141097,港北区,樽町四丁目,58,26,19,7
2016/9/30,141097,港北区,樽町四丁目,59,19,12,7
2016/9/30,141097,港北区,樽町四丁目,60,25,8,17
2016/9/30,141097,港北区,樽町四丁目,61,30,15,15
2016/9/30,141097,港北区,樽町四丁目,62,26,11,15
2016/9/30,141097,港北区,樽町四丁目,63,18,8,10
2016/9/30,141097,港北区,樽町四丁目,64,21,13,8
2016/9/30,141097,港北区,樽町四丁目,65,16,10,6
2016/9/30,141097,港北区,樽町四丁目,66,18,11,7
2016/9/30,141097,港北区,樽町四丁目,67,32,13,19
2016/9/30,141097,港北区,樽町四丁目,68,27,13,14
2016/9/30,141097,港北区,樽町四丁目,69,21,10,11
2016/9/30,141097,港北区,樽町四丁目,70,17,11,6
2016/9/30,141097,港北区,樽町四丁目,71,18,11,7
2016/9/30,141097,港北区,樽町四丁目,72,12,9,3
2016/9/30,141097,港北区,樽町四丁目,73,17,9,8
2016/9/30,141097,港北区,樽町四丁目,74,17,6,11
2016/9/30,141097,港北区,樽町四丁目,75,27,10,17
2016/9/30,141097,港北区,樽町四丁目,76,11,5,6
2016/9/30,141097,港北区,樽町四丁目,77,10,4,6
2016/9/30,141097,港北区,樽町四丁目,78,15,5,10
2016/9/30,141097,港北区,樽町四丁目,79,8,4,4
2016/9/30,141097,港北区,樽町四丁目,80,16,8,8
2016/9/30,141097,港北区,樽町四丁目,81,12,5,7
2016/9/30,141097,港北区,樽町四丁目,82,9,3,6
2016/9/30,141097,港北区,樽町四丁目,83,9,4,5
2016/9/30,141097,港北区,樽町四丁目,84,7,1,6
2016/9/30,141097,港北区,樽町四丁目,85,9,3,6
2016/9/30,141097,港北区,樽町四丁目,86,3,1,2
2016/9/30,141097,港北区,樽町四丁目,87,5,2,3
2016/9/30,141097,港北区,樽町四丁目,88,5,0,5
2016/9/30,141097,港北区,樽町四丁目,89,2,0,2
2016/9/30,141097,港北区,樽町四丁目,90,3,1,2
2016/9/30,141097,港北区,樽町四丁目,91,2,1,1
2016/9/30,141097,港北区,樽町四丁目,92,2,0,2
2016/9/30,141097,港北区,樽町四丁目,93,3,0,3
2016/9/30,141097,港北区,樽町四丁目,94,1,0,1
2016/9/30,141097,港北区,樽町四丁目,95,0,0,0
2016/9/30,141097,港北区,樽町四丁目,96,0,0,0
2016/9/30,141097,港北区,樽町四丁目,97,0,0,0
2016/9/30,141097,港北区,樽町四丁目,98,0,0,0
2016/9/30,141097,港北区,樽町四丁目,99,0,0,0
2016/9/30,141097,港北区,樽町四丁目,100,0,0,0
2016/9/30,141097,港北区,綱島東一丁目,合計,2860,1383,1477
2016/9/30,141097,港北区,綱島東一丁目,0,47,20,27
2016/9/30,141097,港北区,綱島東一丁目,1,38,25,13
2016/9/30,141097,港北区,綱島東一丁目,2,39,14,25
2016/9/30,141097,港北区,綱島東一丁目,3,24,18,6
2016/9/30,141097,港北区,綱島東一丁目,4,21,5,16
2016/9/30,141097,港北区,綱島東一丁目,5,21,9,12
2016/9/30,141097,港北区,綱島東一丁目,6,20,11,9
2016/9/30,141097,港北区,綱島東一丁目,7,14,5,9
2016/9/30,141097,港北区,綱島東一丁目,8,11,5,6
2016/9/30,141097,港北区,綱島東一丁目,9,17,9,8
2016/9/30,141097,港北区,綱島東一丁目,10,12,9,3
2016/9/30,141097,港北区,綱島東一丁目,11,7,4,3
2016/9/30,141097,港北区,綱島東一丁目,12,13,4,9
2016/9/30,141097,港北区,綱島東一丁目,13,13,4,9
2016/9/30,141097,港北区,綱島東一丁目,14,10,4,6
2016/9/30,141097,港北区,綱島東一丁目,15,15,6,9
2016/9/30,141097,港北区,綱島東一丁目,16,4,3,1
2016/9/30,141097,港北区,綱島東一丁目,17,13,3,10
2016/9/30,141097,港北区,綱島東一丁目,18,16,6,10
2016/9/30,141097,港北区,綱島東一丁目,19,14,9,5
2016/9/30,141097,港北区,綱島東一丁目,20,21,14,7
2016/9/30,141097,港北区,綱島東一丁目,21,21,15,6
2016/9/30,141097,港北区,綱島東一丁目,22,29,19,10
2016/9/30,141097,港北区,綱島東一丁目,23,29,14,15
2016/9/30,141097,港北区,綱島東一丁目,24,38,20,18
2016/9/30,141097,港北区,綱島東一丁目,25,43,20,23
2016/9/30,141097,港北区,綱島東一丁目,26,71,35,36
2016/9/30,141097,港北区,綱島東一丁目,27,74,31,43
2016/9/30,141097,港北区,綱島東一丁目,28,73,33,40
2016/9/30,141097,港北区,綱島東一丁目,29,75,38,37
2016/9/30,141097,港北区,綱島東一丁目,30,85,40,45
2016/9/30,141097,港北区,綱島東一丁目,31,82,46,36
2016/9/30,141097,港北区,綱島東一丁目,32,84,35,49
2016/9/30,141097,港北区,綱島東一丁目,33,66,33,33
2016/9/30,141097,港北区,綱島東一丁目,34,81,40,41
2016/9/30,141097,港北区,綱島東一丁目,35,65,33,32
2016/9/30,141097,港北区,綱島東一丁目,36,70,41,29
2016/9/30,141097,港北区,綱島東一丁目,37,75,35,40
2016/9/30,141097,港北区,綱島東一丁目,38,55,28,27
2016/9/30,141097,港北区,綱島東一丁目,39,56,26,30
2016/9/30,141097,港北区,綱島東一丁目,40,63,36,27
2016/9/30,141097,港北区,綱島東一丁目,41,59,28,31
2016/9/30,141097,港北区,綱島東一丁目,42,67,31,36
2016/9/30,141097,港北区,綱島東一丁目,43,53,23,30
2016/9/30,141097,港北区,綱島東一丁目,44,61,25,36
2016/9/30,141097,港北区,綱島東一丁目,45,53,29,24
2016/9/30,141097,港北区,綱島東一丁目,46,45,24,21
2016/9/30,141097,港北区,綱島東一丁目,47,48,25,23
2016/9/30,141097,港北区,綱島東一丁目,48,51,20,31
2016/9/30,141097,港北区,綱島東一丁目,49,50,24,26
2016/9/30,141097,港北区,綱島東一丁目,50,40,18,22
2016/9/30,141097,港北区,綱島東一丁目,51,39,18,21
2016/9/30,141097,港北区,綱島東一丁目,52,33,17,16
2016/9/30,141097,港北区,綱島東一丁目,53,34,17,17
2016/9/30,141097,港北区,綱島東一丁目,54,34,17,17
2016/9/30,141097,港北区,綱島東一丁目,55,33,18,15
2016/9/30,141097,港北区,綱島東一丁目,56,25,12,13
2016/9/30,141097,港北区,綱島東一丁目,57,28,11,17
2016/9/30,141097,港北区,綱島東一丁目,58,17,11,6
2016/9/30,141097,港北区,綱島東一丁目,59,17,10,7
2016/9/30,141097,港北区,綱島東一丁目,60,21,5,16
2016/9/30,141097,港北区,綱島東一丁目,61,18,10,8
2016/9/30,141097,港北区,綱島東一丁目,62,8,5,3
2016/9/30,141097,港北区,綱島東一丁目,63,20,7,13
2016/9/30,141097,港北区,綱島東一丁目,64,22,13,9
2016/9/30,141097,港北区,綱島東一丁目,65,21,12,9
2016/9/30,141097,港北区,綱島東一丁目,66,18,7,11
2016/9/30,141097,港北区,綱島東一丁目,67,25,15,10
2016/9/30,141097,港北区,綱島東一丁目,68,24,11,13
2016/9/30,141097,港北区,綱島東一丁目,69,25,9,16
2016/9/30,141097,港北区,綱島東一丁目,70,13,4,9
2016/9/30,141097,港北区,綱島東一丁目,71,14,9,5
2016/9/30,141097,港北区,綱島東一丁目,72,21,11,10
2016/9/30,141097,港北区,綱島東一丁目,73,15,7,8
2016/9/30,141097,港北区,綱島東一丁目,74,18,8,10
2016/9/30,141097,港北区,綱島東一丁目,75,17,9,8
2016/9/30,141097,港北区,綱島東一丁目,76,20,8,12
2016/9/30,141097,港北区,綱島東一丁目,77,13,6,7
2016/9/30,141097,港北区,綱島東一丁目,78,13,5,8
2016/9/30,141097,港北区,綱島東一丁目,79,9,2,7
2016/9/30,141097,港北区,綱島東一丁目,80,11,5,6
2016/9/30,141097,港北区,綱島東一丁目,81,7,3,4
2016/9/30,141097,港北区,綱島東一丁目,82,12,6,6
2016/9/30,141097,港北区,綱島東一丁目,83,9,4,5
2016/9/30,141097,港北区,綱島東一丁目,84,13,5,8
2016/9/30,141097,港北区,綱島東一丁目,85,7,2,5
2016/9/30,141097,港北区,綱島東一丁目,86,7,2,5
2016/9/30,141097,港北区,綱島東一丁目,87,5,2,3
2016/9/30,141097,港北区,綱島東一丁目,88,5,1,4
2016/9/30,141097,港北区,綱島東一丁目,89,5,3,2
2016/9/30,141097,港北区,綱島東一丁目,90,4,3,1
2016/9/30,141097,港北区,綱島東一丁目,91,1,0,1
2016/9/30,141097,港北区,綱島東一丁目,92,2,0,2
2016/9/30,141097,港北区,綱島東一丁目,93,3,1,2
2016/9/30,141097,港北区,綱島東一丁目,94,0,0,0
2016/9/30,141097,港北区,綱島東一丁目,95,0,0,0
2016/9/30,141097,港北区,綱島東一丁目,96,1,0,1
2016/9/30,141097,港北区,綱島東一丁目,97,1,0,1
2016/9/30,141097,港北区,綱島東一丁目,98,0,0,0
2016/9/30,141097,港北区,綱島東一丁目,99,0,0,0
2016/9/30,141097,港北区,綱島東一丁目,100,0,0,0
2016/9/30,141097,港北区,綱島東二丁目,合計,1656,851,805
2016/9/30,141097,港北区,綱島東二丁目,0,31,14,17
2016/9/30,141097,港北区,綱島東二丁目,1,30,12,18
2016/9/30,141097,港北区,綱島東二丁目,2,20,7,13
2016/9/30,141097,港北区,綱島東二丁目,3,17,8,9
2016/9/30,141097,港北区,綱島東二丁目,4,16,9,7
2016/9/30,141097,港北区,綱島東二丁目,5,9,7,2
2016/9/30,141097,港北区,綱島東二丁目,6,7,4,3
2016/9/30,141097,港北区,綱島東二丁目,7,8,3,5
2016/9/30,141097,港北区,綱島東二丁目,8,8,5,3
2016/9/30,141097,港北区,綱島東二丁目,9,4,1,3
2016/9/30,141097,港北区,綱島東二丁目,10,5,2,3
2016/9/30,141097,港北区,綱島東二丁目,11,3,0,3
2016/9/30,141097,港北区,綱島東二丁目,12,9,3,6
2016/9/30,141097,港北区,綱島東二丁目,13,2,1,1
2016/9/30,141097,港北区,綱島東二丁目,14,5,2,3
2016/9/30,141097,港北区,綱島東二丁目,15,3,3,0
2016/9/30,141097,港北区,綱島東二丁目,16,9,5,4
2016/9/30,141097,港北区,綱島東二丁目,17,3,2,1
2016/9/30,141097,港北区,綱島東二丁目,18,6,1,5
2016/9/30,141097,港北区,綱島東二丁目,19,9,4,5
2016/9/30,141097,港北区,綱島東二丁目,20,7,2,5
2016/9/30,141097,港北区,綱島東二丁目,21,13,7,6
2016/9/30,141097,港北区,綱島東二丁目,22,16,9,7
2016/9/30,141097,港北区,綱島東二丁目,23,27,15,12
2016/9/30,141097,港北区,綱島東二丁目,24,17,9,8
2016/9/30,141097,港北区,綱島東二丁目,25,19,10,9
2016/9/30,141097,港北区,綱島東二丁目,26,45,28,17
2016/9/30,141097,港北区,綱島東二丁目,27,46,16,30
2016/9/30,141097,港北区,綱島東二丁目,28,56,28,28
2016/9/30,141097,港北区,綱島東二丁目,29,49,24,25
2016/9/30,141097,港北区,綱島東二丁目,30,63,37,26
2016/9/30,141097,港北区,綱島東二丁目,31,61,30,31
2016/9/30,141097,港北区,綱島東二丁目,32,69,39,30
2016/9/30,141097,港北区,綱島東二丁目,33,48,26,22
2016/9/30,141097,港北区,綱島東二丁目,34,47,22,25
2016/9/30,141097,港北区,綱島東二丁目,35,47,21,26
2016/9/30,141097,港北区,綱島東二丁目,36,46,24,22
2016/9/30,141097,港北区,綱島東二丁目,37,40,19,21
2016/9/30,141097,港北区,綱島東二丁目,38,41,22,19
2016/9/30,141097,港北区,綱島東二丁目,39,29,19,10
2016/9/30,141097,港北区,綱島東二丁目,40,34,17,17
2016/9/30,141097,港北区,綱島東二丁目,41,26,13,13
2016/9/30,141097,港北区,綱島東二丁目,42,26,15,11
2016/9/30,141097,港北区,綱島東二丁目,43,26,11,15
2016/9/30,141097,港北区,綱島東二丁目,44,19,8,11
2016/9/30,141097,港北区,綱島東二丁目,45,24,15,9
2016/9/30,141097,港北区,綱島東二丁目,46,19,13,6
2016/9/30,141097,港北区,綱島東二丁目,47,28,16,12
2016/9/30,141097,港北区,綱島東二丁目,48,22,10,12
2016/9/30,141097,港北区,綱島東二丁目,49,19,16,3
2016/9/30,141097,港北区,綱島東二丁目,50,15,9,6
2016/9/30,141097,港北区,綱島東二丁目,51,19,11,8
2016/9/30,141097,港北区,綱島東二丁目,52,20,11,9
2016/9/30,141097,港北区,綱島東二丁目,53,18,9,9
2016/9/30,141097,港北区,綱島東二丁目,54,18,8,10
2016/9/30,141097,港北区,綱島東二丁目,55,21,12,9
2016/9/30,141097,港北区,綱島東二丁目,56,17,8,9
2016/9/30,141097,港北区,綱島東二丁目,57,25,15,10
2016/9/30,141097,港北区,綱島東二丁目,58,20,12,8
2016/9/30,141097,港北区,綱島東二丁目,59,13,7,6
2016/9/30,141097,港北区,綱島東二丁目,60,6,3,3
2016/9/30,141097,港北区,綱島東二丁目,61,8,5,3
2016/9/30,141097,港北区,綱島東二丁目,62,10,6,4
2016/9/30,141097,港北区,綱島東二丁目,63,10,6,4
2016/9/30,141097,港北区,綱島東二丁目,64,17,8,9
2016/9/30,141097,港北区,綱島東二丁目,65,14,7,7
2016/9/30,141097,港北区,綱島東二丁目,66,13,6,7
2016/9/30,141097,港北区,綱島東二丁目,67,13,7,6
2016/9/30,141097,港北区,綱島東二丁目,68,12,5,7
2016/9/30,141097,港北区,綱島東二丁目,69,10,8,2
2016/9/30,141097,港北区,綱島東二丁目,70,8,4,4
2016/9/30,141097,港北区,綱島東二丁目,71,8,5,3
2016/9/30,141097,港北区,綱島東二丁目,72,5,2,3
2016/9/30,141097,港北区,綱島東二丁目,73,8,2,6
2016/9/30,141097,港北区,綱島東二丁目,74,6,3,3
2016/9/30,141097,港北区,綱島東二丁目,75,2,1,1
2016/9/30,141097,港北区,綱島東二丁目,76,7,3,4
2016/9/30,141097,港北区,綱島東二丁目,77,8,3,5
2016/9/30,141097,港北区,綱島東二丁目,78,4,1,3
2016/9/30,141097,港北区,綱島東二丁目,79,8,5,3
2016/9/30,141097,港北区,綱島東二丁目,80,4,3,1
2016/9/30,141097,港北区,綱島東二丁目,81,7,3,4
2016/9/30,141097,港北区,綱島東二丁目,82,3,1,2
2016/9/30,141097,港北区,綱島東二丁目,83,5,2,3
2016/9/30,141097,港北区,綱島東二丁目,84,6,3,3
2016/9/30,141097,港北区,綱島東二丁目,85,2,1,1
2016/9/30,141097,港北区,綱島東二丁目,86,6,1,5
2016/9/30,141097,港北区,綱島東二丁目,87,5,2,3
2016/9/30,141097,港北区,綱島東二丁目,88,2,1,1
2016/9/30,141097,港北区,綱島東二丁目,89,4,1,3
2016/9/30,141097,港北区,綱島東二丁目,90,4,3,1
2016/9/30,141097,港北区,綱島東二丁目,91,2,1,1
2016/9/30,141097,港北区,綱島東二丁目,92,3,1,2
2016/9/30,141097,港北区,綱島東二丁目,93,3,2,1
2016/9/30,141097,港北区,綱島東二丁目,94,2,0,2
2016/9/30,141097,港北区,綱島東二丁目,95,1,0,1
2016/9/30,141097,港北区,綱島東二丁目,96,0,0,0
2016/9/30,141097,港北区,綱島東二丁目,97,0,0,0
2016/9/30,141097,港北区,綱島東二丁目,98,1,0,1
2016/9/30,141097,港北区,綱島東二丁目,99,0,0,0
2016/9/30,141097,港北区,綱島東二丁目,100,0,0,0
2016/9/30,141097,港北区,綱島東三丁目,合計,3362,1744,1618
2016/9/30,141097,港北区,綱島東三丁目,0,80,47,33
2016/9/30,141097,港北区,綱島東三丁目,1,55,30,25
2016/9/30,141097,港北区,綱島東三丁目,2,35,16,19
2016/9/30,141097,港北区,綱島東三丁目,3,38,14,24
2016/9/30,141097,港北区,綱島東三丁目,4,35,13,22
2016/9/30,141097,港北区,綱島東三丁目,5,36,21,15
2016/9/30,141097,港北区,綱島東三丁目,6,35,20,15
2016/9/30,141097,港北区,綱島東三丁目,7,22,15,7
2016/9/30,141097,港北区,綱島東三丁目,8,25,10,15
2016/9/30,141097,港北区,綱島東三丁目,9,20,7,13
2016/9/30,141097,港北区,綱島東三丁目,10,17,8,9
2016/9/30,141097,港北区,綱島東三丁目,11,28,18,10
2016/9/30,141097,港北区,綱島東三丁目,12,18,11,7
2016/9/30,141097,港北区,綱島東三丁目,13,30,19,11
2016/9/30,141097,港北区,綱島東三丁目,14,26,17,9
2016/9/30,141097,港北区,綱島東三丁目,15,16,10,6
2016/9/30,141097,港北区,綱島東三丁目,16,16,6,10
2016/9/30,141097,港北区,綱島東三丁目,17,36,19,17
2016/9/30,141097,港北区,綱島東三丁目,18,40,22,18
2016/9/30,141097,港北区,綱島東三丁目,19,30,13,17
2016/9/30,141097,港北区,綱島東三丁目,20,35,19,16
2016/9/30,141097,港北区,綱島東三丁目,21,39,26,13
2016/9/30,141097,港北区,綱島東三丁目,22,39,20,19
2016/9/30,141097,港北区,綱島東三丁目,23,39,23,16
2016/9/30,141097,港北区,綱島東三丁目,24,45,23,22
2016/9/30,141097,港北区,綱島東三丁目,25,50,26,24
2016/9/30,141097,港北区,綱島東三丁目,26,40,26,14
2016/9/30,141097,港北区,綱島東三丁目,27,72,29,43
2016/9/30,141097,港北区,綱島東三丁目,28,78,34,44
2016/9/30,141097,港北区,綱島東三丁目,29,80,37,43
2016/9/30,141097,港北区,綱島東三丁目,30,81,36,45
2016/9/30,141097,港北区,綱島東三丁目,31,85,45,40
2016/9/30,141097,港北区,綱島東三丁目,32,96,53,43
2016/9/30,141097,港北区,綱島東三丁目,33,83,41,42
2016/9/30,141097,港北区,綱島東三丁目,34,79,36,43
2016/9/30,141097,港北区,綱島東三丁目,35,88,44,44
2016/9/30,141097,港北区,綱島東三丁目,36,92,56,36
2016/9/30,141097,港北区,綱島東三丁目,37,85,45,40
2016/9/30,141097,港北区,綱島東三丁目,38,77,40,37
2016/9/30,141097,港北区,綱島東三丁目,39,70,37,33
2016/9/30,141097,港北区,綱島東三丁目,40,67,40,27
2016/9/30,141097,港北区,綱島東三丁目,41,75,41,34
2016/9/30,141097,港北区,綱島東三丁目,42,60,32,28
2016/9/30,141097,港北区,綱島東三丁目,43,70,30,40
2016/9/30,141097,港北区,綱島東三丁目,44,53,32,21
2016/9/30,141097,港北区,綱島東三丁目,45,49,28,21
2016/9/30,141097,港北区,綱島東三丁目,46,54,28,26
2016/9/30,141097,港北区,綱島東三丁目,47,68,35,33
2016/9/30,141097,港北区,綱島東三丁目,48,51,22,29
2016/9/30,141097,港北区,綱島東三丁目,49,53,35,18
2016/9/30,141097,港北区,綱島東三丁目,50,43,22,21
2016/9/30,141097,港北区,綱島東三丁目,51,52,25,27
2016/9/30,141097,港北区,綱島東三丁目,52,52,29,23
2016/9/30,141097,港北区,綱島東三丁目,53,35,18,17
2016/9/30,141097,港北区,綱島東三丁目,54,40,26,14
2016/9/30,141097,港北区,綱島東三丁目,55,49,24,25
2016/9/30,141097,港北区,綱島東三丁目,56,27,13,14
2016/9/30,141097,港北区,綱島東三丁目,57,24,16,8
2016/9/30,141097,港北区,綱島東三丁目,58,21,10,11
2016/9/30,141097,港北区,綱島東三丁目,59,31,19,12
2016/9/30,141097,港北区,綱島東三丁目,60,15,12,3
2016/9/30,141097,港北区,綱島東三丁目,61,17,12,5
2016/9/30,141097,港北区,綱島東三丁目,62,19,9,10
2016/9/30,141097,港北区,綱島東三丁目,63,13,5,8
2016/9/30,141097,港北区,綱島東三丁目,64,11,4,7
2016/9/30,141097,港北区,綱島東三丁目,65,18,10,8
2016/9/30,141097,港北区,綱島東三丁目,66,12,6,6
2016/9/30,141097,港北区,綱島東三丁目,67,28,12,16
2016/9/30,141097,港北区,綱島東三丁目,68,25,16,9
2016/9/30,141097,港北区,綱島東三丁目,69,21,10,11
2016/9/30,141097,港北区,綱島東三丁目,70,11,6,5
2016/9/30,141097,港北区,綱島東三丁目,71,13,4,9
2016/9/30,141097,港北区,綱島東三丁目,72,22,12,10
2016/9/30,141097,港北区,綱島東三丁目,73,14,5,9
2016/9/30,141097,港北区,綱島東三丁目,74,18,9,9
2016/9/30,141097,港北区,綱島東三丁目,75,25,11,14
2016/9/30,141097,港北区,綱島東三丁目,76,12,6,6
2016/9/30,141097,港北区,綱島東三丁目,77,6,3,3
2016/9/30,141097,港北区,綱島東三丁目,78,12,6,6
2016/9/30,141097,港北区,綱島東三丁目,79,19,8,11
2016/9/30,141097,港北区,綱島東三丁目,80,5,1,4
2016/9/30,141097,港北区,綱島東三丁目,81,5,0,5
2016/9/30,141097,港北区,綱島東三丁目,82,8,2,6
2016/9/30,141097,港北区,綱島東三丁目,83,3,2,1
2016/9/30,141097,港北区,綱島東三丁目,84,9,4,5
2016/9/30,141097,港北区,綱島東三丁目,85,8,3,5
2016/9/30,141097,港北区,綱島東三丁目,86,5,2,3
2016/9/30,141097,港北区,綱島東三丁目,87,7,2,5
2016/9/30,141097,港北区,綱島東三丁目,88,3,0,3
2016/9/30,141097,港北区,綱島東三丁目,89,1,0,1
2016/9/30,141097,港北区,綱島東三丁目,90,4,2,2
2016/9/30,141097,港北区,綱島東三丁目,91,2,2,0
2016/9/30,141097,港北区,綱島東三丁目,92,1,1,0
2016/9/30,141097,港北区,綱島東三丁目,93,0,0,0
2016/9/30,141097,港北区,綱島東三丁目,94,1,0,1
2016/9/30,141097,港北区,綱島東三丁目,95,0,0,0
2016/9/30,141097,港北区,綱島東三丁目,96,1,0,1
2016/9/30,141097,港北区,綱島東三丁目,97,1,0,1
2016/9/30,141097,港北区,綱島東三丁目,98,1,0,1
2016/9/30,141097,港北区,綱島東三丁目,99,1,0,1
2016/9/30,141097,港北区,綱島東三丁目,100,0,0,0
2016/9/30,141097,港北区,綱島東四丁目,合計,3791,1928,1863
2016/9/30,141097,港北区,綱島東四丁目,0,52,26,26
2016/9/30,141097,港北区,綱島東四丁目,1,85,54,31
2016/9/30,141097,港北区,綱島東四丁目,2,66,31,35
2016/9/30,141097,港北区,綱島東四丁目,3,67,33,34
2016/9/30,141097,港北区,綱島東四丁目,4,63,32,31
2016/9/30,141097,港北区,綱島東四丁目,5,55,34,21
2016/9/30,141097,港北区,綱島東四丁目,6,60,33,27
2016/9/30,141097,港北区,綱島東四丁目,7,43,14,29
2016/9/30,141097,港北区,綱島東四丁目,8,34,19,15
2016/9/30,141097,港北区,綱島東四丁目,9,32,14,18
2016/9/30,141097,港北区,綱島東四丁目,10,22,8,14
2016/9/30,141097,港北区,綱島東四丁目,11,26,12,14
2016/9/30,141097,港北区,綱島東四丁目,12,30,12,18
2016/9/30,141097,港北区,綱島東四丁目,13,18,11,7
2016/9/30,141097,港北区,綱島東四丁目,14,32,12,20
2016/9/30,141097,港北区,綱島東四丁目,15,30,14,16
2016/9/30,141097,港北区,綱島東四丁目,16,20,10,10
2016/9/30,141097,港北区,綱島東四丁目,17,22,9,13
2016/9/30,141097,港北区,綱島東四丁目,18,30,10,20
2016/9/30,141097,港北区,綱島東四丁目,19,37,20,17
2016/9/30,141097,港北区,綱島東四丁目,20,35,20,15
2016/9/30,141097,港北区,綱島東四丁目,21,33,23,10
2016/9/30,141097,港北区,綱島東四丁目,22,37,15,22
2016/9/30,141097,港北区,綱島東四丁目,23,31,15,16
2016/9/30,141097,港北区,綱島東四丁目,24,39,19,20
2016/9/30,141097,港北区,綱島東四丁目,25,35,20,15
2016/9/30,141097,港北区,綱島東四丁目,26,38,18,20
2016/9/30,141097,港北区,綱島東四丁目,27,48,23,25
2016/9/30,141097,港北区,綱島東四丁目,28,62,34,28
2016/9/30,141097,港北区,綱島東四丁目,29,55,28,27
2016/9/30,141097,港北区,綱島東四丁目,30,69,32,37
2016/9/30,141097,港北区,綱島東四丁目,31,67,38,29
2016/9/30,141097,港北区,綱島東四丁目,32,62,36,26
2016/9/30,141097,港北区,綱島東四丁目,33,78,33,45
2016/9/30,141097,港北区,綱島東四丁目,34,111,56,55
2016/9/30,141097,港北区,綱島東四丁目,35,91,42,49
2016/9/30,141097,港北区,綱島東四丁目,36,77,46,31
2016/9/30,141097,港北区,綱島東四丁目,37,102,44,58
2016/9/30,141097,港北区,綱島東四丁目,38,107,53,54
2016/9/30,141097,港北区,綱島東四丁目,39,86,53,33
2016/9/30,141097,港北区,綱島東四丁目,40,90,38,52
2016/9/30,141097,港北区,綱島東四丁目,41,91,53,38
2016/9/30,141097,港北区,綱島東四丁目,42,100,55,45
2016/9/30,141097,港北区,綱島東四丁目,43,76,38,38
2016/9/30,141097,港北区,綱島東四丁目,44,82,44,38
2016/9/30,141097,港北区,綱島東四丁目,45,80,48,32
2016/9/30,141097,港北区,綱島東四丁目,46,83,42,41
2016/9/30,141097,港北区,綱島東四丁目,47,66,31,35
2016/9/30,141097,港北区,綱島東四丁目,48,61,29,32
2016/9/30,141097,港北区,綱島東四丁目,49,69,40,29
2016/9/30,141097,港北区,綱島東四丁目,50,50,27,23
2016/9/30,141097,港北区,綱島東四丁目,51,48,29,19
2016/9/30,141097,港北区,綱島東四丁目,52,53,29,24
2016/9/30,141097,港北区,綱島東四丁目,53,45,25,20
2016/9/30,141097,港北区,綱島東四丁目,54,48,29,19
2016/9/30,141097,港北区,綱島東四丁目,55,36,21,15
2016/9/30,141097,港北区,綱島東四丁目,56,40,23,17
2016/9/30,141097,港北区,綱島東四丁目,57,30,15,15
2016/9/30,141097,港北区,綱島東四丁目,58,35,13,22
2016/9/30,141097,港北区,綱島東四丁目,59,24,18,6
2016/9/30,141097,港北区,綱島東四丁目,60,27,18,9
2016/9/30,141097,港北区,綱島東四丁目,61,17,5,12
2016/9/30,141097,港北区,綱島東四丁目,62,20,9,11
2016/9/30,141097,港北区,綱島東四丁目,63,33,18,15
2016/9/30,141097,港北区,綱島東四丁目,64,26,12,14
2016/9/30,141097,港北区,綱島東四丁目,65,15,9,6
2016/9/30,141097,港北区,綱島東四丁目,66,24,10,14
2016/9/30,141097,港北区,綱島東四丁目,67,32,19,13
2016/9/30,141097,港北区,綱島東四丁目,68,31,12,19
2016/9/30,141097,港北区,綱島東四丁目,69,31,13,18
2016/9/30,141097,港北区,綱島東四丁目,70,14,4,10
2016/9/30,141097,港北区,綱島東四丁目,71,15,7,8
2016/9/30,141097,港北区,綱島東四丁目,72,12,4,8
2016/9/30,141097,港北区,綱島東四丁目,73,16,11,5
2016/9/30,141097,港北区,綱島東四丁目,74,16,6,10
2016/9/30,141097,港北区,綱島東四丁目,75,15,9,6
2016/9/30,141097,港北区,綱島東四丁目,76,18,10,8
2016/9/30,141097,港北区,綱島東四丁目,77,19,7,12
2016/9/30,141097,港北区,綱島東四丁目,78,14,6,8
2016/9/30,141097,港北区,綱島東四丁目,79,14,9,5
2016/9/30,141097,港北区,綱島東四丁目,80,8,3,5
2016/9/30,141097,港北区,綱島東四丁目,81,9,2,7
2016/9/30,141097,港北区,綱島東四丁目,82,7,3,4
2016/9/30,141097,港北区,綱島東四丁目,83,9,3,6
2016/9/30,141097,港北区,綱島東四丁目,84,7,3,4
2016/9/30,141097,港北区,綱島東四丁目,85,7,2,5
2016/9/30,141097,港北区,綱島東四丁目,86,8,2,6
2016/9/30,141097,港北区,綱島東四丁目,87,8,2,6
2016/9/30,141097,港北区,綱島東四丁目,88,8,2,6
2016/9/30,141097,港北区,綱島東四丁目,89,2,2,0
2016/9/30,141097,港北区,綱島東四丁目,90,4,1,3
2016/9/30,141097,港北区,綱島東四丁目,91,3,1,2
2016/9/30,141097,港北区,綱島東四丁目,92,1,0,1
2016/9/30,141097,港北区,綱島東四丁目,93,1,0,1
2016/9/30,141097,港北区,綱島東四丁目,94,2,1,1
2016/9/30,141097,港北区,綱島東四丁目,95,0,0,0
2016/9/30,141097,港北区,綱島東四丁目,96,1,0,1
2016/9/30,141097,港北区,綱島東四丁目,97,0,0,0
2016/9/30,141097,港北区,綱島東四丁目,98,0,0,0
2016/9/30,141097,港北区,綱島東四丁目,99,1,0,1
2016/9/30,141097,港北区,綱島東四丁目,100,2,0,2
2016/9/30,141097,港北区,綱島東五丁目,合計,3181,1649,1532
2016/9/30,141097,港北区,綱島東五丁目,0,25,12,13
2016/9/30,141097,港北区,綱島東五丁目,1,24,14,10
2016/9/30,141097,港北区,綱島東五丁目,2,24,9,15
2016/9/30,141097,港北区,綱島東五丁目,3,27,16,11
2016/9/30,141097,港北区,綱島東五丁目,4,19,10,9
2016/9/30,141097,港北区,綱島東五丁目,5,27,10,17
2016/9/30,141097,港北区,綱島東五丁目,6,21,13,8
2016/9/30,141097,港北区,綱島東五丁目,7,32,17,15
2016/9/30,141097,港北区,綱島東五丁目,8,26,7,19
2016/9/30,141097,港北区,綱島東五丁目,9,36,25,11
2016/9/30,141097,港北区,綱島東五丁目,10,22,13,9
2016/9/30,141097,港北区,綱島東五丁目,11,25,17,8
2016/9/30,141097,港北区,綱島東五丁目,12,25,12,13
2016/9/30,141097,港北区,綱島東五丁目,13,20,10,10
2016/9/30,141097,港北区,綱島東五丁目,14,31,19,12
2016/9/30,141097,港北区,綱島東五丁目,15,27,12,15
2016/9/30,141097,港北区,綱島東五丁目,16,35,17,18
2016/9/30,141097,港北区,綱島東五丁目,17,34,16,18
2016/9/30,141097,港北区,綱島東五丁目,18,38,23,15
2016/9/30,141097,港北区,綱島東五丁目,19,29,16,13
2016/9/30,141097,港北区,綱島東五丁目,20,34,19,15
2016/9/30,141097,港北区,綱島東五丁目,21,42,26,16
2016/9/30,141097,港北区,綱島東五丁目,22,39,22,17
2016/9/30,141097,港北区,綱島東五丁目,23,38,26,12
2016/9/30,141097,港北区,綱島東五丁目,24,39,26,13
2016/9/30,141097,港北区,綱島東五丁目,25,40,24,16
2016/9/30,141097,港北区,綱島東五丁目,26,36,21,15
2016/9/30,141097,港北区,綱島東五丁目,27,27,14,13
2016/9/30,141097,港北区,綱島東五丁目,28,38,12,26
2016/9/30,141097,港北区,綱島東五丁目,29,33,16,17
2016/9/30,141097,港北区,綱島東五丁目,30,38,24,14
2016/9/30,141097,港北区,綱島東五丁目,31,43,26,17
2016/9/30,141097,港北区,綱島東五丁目,32,46,24,22
2016/9/30,141097,港北区,綱島東五丁目,33,49,29,20
2016/9/30,141097,港北区,綱島東五丁目,34,36,18,18
2016/9/30,141097,港北区,綱島東五丁目,35,43,24,19
2016/9/30,141097,港北区,綱島東五丁目,36,40,23,17
2016/9/30,141097,港北区,綱島東五丁目,37,48,30,18
2016/9/30,141097,港北区,綱島東五丁目,38,52,30,22
2016/9/30,141097,港北区,綱島東五丁目,39,54,24,30
2016/9/30,141097,港北区,綱島東五丁目,40,70,33,37
2016/9/30,141097,港北区,綱島東五丁目,41,54,31,23
2016/9/30,141097,港北区,綱島東五丁目,42,50,27,23
2016/9/30,141097,港北区,綱島東五丁目,43,43,22,21
2016/9/30,141097,港北区,綱島東五丁目,44,60,32,28
2016/9/30,141097,港北区,綱島東五丁目,45,60,34,26
2016/9/30,141097,港北区,綱島東五丁目,46,61,26,35
2016/9/30,141097,港北区,綱島東五丁目,47,57,34,23
2016/9/30,141097,港北区,綱島東五丁目,48,68,38,30
2016/9/30,141097,港北区,綱島東五丁目,49,64,35,29
2016/9/30,141097,港北区,綱島東五丁目,50,45,25,20
2016/9/30,141097,港北区,綱島東五丁目,51,51,30,21
2016/9/30,141097,港北区,綱島東五丁目,52,47,24,23
2016/9/30,141097,港北区,綱島東五丁目,53,41,18,23
2016/9/30,141097,港北区,綱島東五丁目,54,46,23,23
2016/9/30,141097,港北区,綱島東五丁目,55,41,25,16
2016/9/30,141097,港北区,綱島東五丁目,56,33,17,16
2016/9/30,141097,港北区,綱島東五丁目,57,29,17,12
2016/9/30,141097,港北区,綱島東五丁目,58,35,15,20
2016/9/30,141097,港北区,綱島東五丁目,59,35,17,18
2016/9/30,141097,港北区,綱島東五丁目,60,23,15,8
2016/9/30,141097,港北区,綱島東五丁目,61,23,16,7
2016/9/30,141097,港北区,綱島東五丁目,62,29,19,10
2016/9/30,141097,港北区,綱島東五丁目,63,29,17,12
2016/9/30,141097,港北区,綱島東五丁目,64,20,12,8
2016/9/30,141097,港北区,綱島東五丁目,65,28,15,13
2016/9/30,141097,港北区,綱島東五丁目,66,42,14,28
2016/9/30,141097,港北区,綱島東五丁目,67,46,19,27
2016/9/30,141097,港北区,綱島東五丁目,68,46,19,27
2016/9/30,141097,港北区,綱島東五丁目,69,35,20,15
2016/9/30,141097,港北区,綱島東五丁目,70,28,14,14
2016/9/30,141097,港北区,綱島東五丁目,71,30,14,16
2016/9/30,141097,港北区,綱島東五丁目,72,32,13,19
2016/9/30,141097,港北区,綱島東五丁目,73,33,13,20
2016/9/30,141097,港北区,綱島東五丁目,74,44,18,26
2016/9/30,141097,港北区,綱島東五丁目,75,41,20,21
2016/9/30,141097,港北区,綱島東五丁目,76,31,16,15
2016/9/30,141097,港北区,綱島東五丁目,77,13,4,9
2016/9/30,141097,港北区,綱島東五丁目,78,21,7,14
2016/9/30,141097,港北区,綱島東五丁目,79,23,12,11
2016/9/30,141097,港北区,綱島東五丁目,80,35,13,22
2016/9/30,141097,港北区,綱島東五丁目,81,24,8,16
2016/9/30,141097,港北区,綱島東五丁目,82,25,13,12
2016/9/30,141097,港北区,綱島東五丁目,83,20,6,14
2016/9/30,141097,港北区,綱島東五丁目,84,18,5,13
2016/9/30,141097,港北区,綱島東五丁目,85,12,5,7
2016/9/30,141097,港北区,綱島東五丁目,86,14,6,8
2016/9/30,141097,港北区,綱島東五丁目,87,14,5,9
2016/9/30,141097,港北区,綱島東五丁目,88,9,3,6
2016/9/30,141097,港北区,綱島東五丁目,89,13,7,6
2016/9/30,141097,港北区,綱島東五丁目,90,4,3,1
2016/9/30,141097,港北区,綱島東五丁目,91,6,1,5
2016/9/30,141097,港北区,綱島東五丁目,92,2,2,0
2016/9/30,141097,港北区,綱島東五丁目,93,4,0,4
2016/9/30,141097,港北区,綱島東五丁目,94,4,1,3
2016/9/30,141097,港北区,綱島東五丁目,95,3,2,1
2016/9/30,141097,港北区,綱島東五丁目,96,2,2,0
2016/9/30,141097,港北区,綱島東五丁目,97,0,0,0
2016/9/30,141097,港北区,綱島東五丁目,98,1,0,1
2016/9/30,141097,港北区,綱島東五丁目,99,0,0,0
2016/9/30,141097,港北区,綱島東五丁目,100,2,1,1
2016/9/30,141097,港北区,綱島東六丁目,合計,862,452,410
2016/9/30,141097,港北区,綱島東六丁目,0,18,6,12
2016/9/30,141097,港北区,綱島東六丁目,1,13,8,5
2016/9/30,141097,港北区,綱島東六丁目,2,10,4,6
2016/9/30,141097,港北区,綱島東六丁目,3,3,1,2
2016/9/30,141097,港北区,綱島東六丁目,4,6,2,4
2016/9/30,141097,港北区,綱島東六丁目,5,5,0,5
2016/9/30,141097,港北区,綱島東六丁目,6,4,1,3
2016/9/30,141097,港北区,綱島東六丁目,7,5,0,5
2016/9/30,141097,港北区,綱島東六丁目,8,4,4,0
2016/9/30,141097,港北区,綱島東六丁目,9,3,1,2
2016/9/30,141097,港北区,綱島東六丁目,10,3,3,0
2016/9/30,141097,港北区,綱島東六丁目,11,7,3,4
2016/9/30,141097,港北区,綱島東六丁目,12,5,2,3
2016/9/30,141097,港北区,綱島東六丁目,13,9,6,3
2016/9/30,141097,港北区,綱島東六丁目,14,1,1,0
2016/9/30,141097,港北区,綱島東六丁目,15,8,5,3
2016/9/30,141097,港北区,綱島東六丁目,16,9,8,1
2016/9/30,141097,港北区,綱島東六丁目,17,5,4,1
2016/9/30,141097,港北区,綱島東六丁目,18,6,3,3
2016/9/30,141097,港北区,綱島東六丁目,19,7,4,3
2016/9/30,141097,港北区,綱島東六丁目,20,6,2,4
2016/9/30,141097,港北区,綱島東六丁目,21,7,2,5
2016/9/30,141097,港北区,綱島東六丁目,22,8,7,1
2016/9/30,141097,港北区,綱島東六丁目,23,9,6,3
2016/9/30,141097,港北区,綱島東六丁目,24,19,11,8
2016/9/30,141097,港北区,綱島東六丁目,25,10,3,7
2016/9/30,141097,港北区,綱島東六丁目,26,15,5,10
2016/9/30,141097,港北区,綱島東六丁目,27,26,13,13
2016/9/30,141097,港北区,綱島東六丁目,28,17,5,12
2016/9/30,141097,港北区,綱島東六丁目,29,28,14,14
2016/9/30,141097,港北区,綱島東六丁目,30,21,15,6
2016/9/30,141097,港北区,綱島東六丁目,31,18,7,11
2016/9/30,141097,港北区,綱島東六丁目,32,21,14,7
2016/9/30,141097,港北区,綱島東六丁目,33,24,15,9
2016/9/30,141097,港北区,綱島東六丁目,34,27,15,12
2016/9/30,141097,港北区,綱島東六丁目,35,7,3,4
2016/9/30,141097,港北区,綱島東六丁目,36,14,9,5
2016/9/30,141097,港北区,綱島東六丁目,37,21,11,10
2016/9/30,141097,港北区,綱島東六丁目,38,19,9,10
2016/9/30,141097,港北区,綱島東六丁目,39,19,13,6
2016/9/30,141097,港北区,綱島東六丁目,40,15,8,7
2016/9/30,141097,港北区,綱島東六丁目,41,13,10,3
2016/9/30,141097,港北区,綱島東六丁目,42,10,6,4
2016/9/30,141097,港北区,綱島東六丁目,43,18,9,9
2016/9/30,141097,港北区,綱島東六丁目,44,14,9,5
2016/9/30,141097,港北区,綱島東六丁目,45,15,7,8
2016/9/30,141097,港北区,綱島東六丁目,46,18,6,12
2016/9/30,141097,港北区,綱島東六丁目,47,9,5,4
2016/9/30,141097,港北区,綱島東六丁目,48,12,7,5
2016/9/30,141097,港北区,綱島東六丁目,49,16,11,5
2016/9/30,141097,港北区,綱島東六丁目,50,8,5,3
2016/9/30,141097,港北区,綱島東六丁目,51,6,4,2
2016/9/30,141097,港北区,綱島東六丁目,52,10,5,5
2016/9/30,141097,港北区,綱島東六丁目,53,6,3,3
2016/9/30,141097,港北区,綱島東六丁目,54,1,0,1
2016/9/30,141097,港北区,綱島東六丁目,55,8,5,3
2016/9/30,141097,港北区,綱島東六丁目,56,7,1,6
2016/9/30,141097,港北区,綱島東六丁目,57,11,8,3
2016/9/30,141097,港北区,綱島東六丁目,58,5,3,2
2016/9/30,141097,港北区,綱島東六丁目,59,8,3,5
2016/9/30,141097,港北区,綱島東六丁目,60,8,4,4
2016/9/30,141097,港北区,綱島東六丁目,61,6,5,1
2016/9/30,141097,港北区,綱島東六丁目,62,13,6,7
2016/9/30,141097,港北区,綱島東六丁目,63,6,5,1
2016/9/30,141097,港北区,綱島東六丁目,64,7,2,5
2016/9/30,141097,港北区,綱島東六丁目,65,5,1,4
2016/9/30,141097,港北区,綱島東六丁目,66,13,6,7
2016/9/30,141097,港北区,綱島東六丁目,67,7,4,3
2016/9/30,141097,港北区,綱島東六丁目,68,9,7,2
2016/9/30,141097,港北区,綱島東六丁目,69,5,2,3
2016/9/30,141097,港北区,綱島東六丁目,70,7,2,5
2016/9/30,141097,港北区,綱島東六丁目,71,6,4,2
2016/9/30,141097,港北区,綱島東六丁目,72,5,0,5
2016/9/30,141097,港北区,綱島東六丁目,73,9,4,5
2016/9/30,141097,港北区,綱島東六丁目,74,11,7,4
2016/9/30,141097,港北区,綱島東六丁目,75,10,4,6
2016/9/30,141097,港北区,綱島東六丁目,76,6,2,4
2016/9/30,141097,港北区,綱島東六丁目,77,7,4,3
2016/9/30,141097,港北区,綱島東六丁目,78,5,5,0
2016/9/30,141097,港北区,綱島東六丁目,79,4,2,2
2016/9/30,141097,港北区,綱島東六丁目,80,7,2,5
2016/9/30,141097,港北区,綱島東六丁目,81,7,4,3
2016/9/30,141097,港北区,綱島東六丁目,82,2,1,1
2016/9/30,141097,港北区,綱島東六丁目,83,4,2,2
2016/9/30,141097,港北区,綱島東六丁目,84,2,2,0
2016/9/30,141097,港北区,綱島東六丁目,85,5,1,4
2016/9/30,141097,港北区,綱島東六丁目,86,1,0,1
2016/9/30,141097,港北区,綱島東六丁目,87,4,2,2
2016/9/30,141097,港北区,綱島東六丁目,88,0,0,0
2016/9/30,141097,港北区,綱島東六丁目,89,1,1,0
2016/9/30,141097,港北区,綱島東六丁目,90,1,1,0
2016/9/30,141097,港北区,綱島東六丁目,91,0,0,0
2016/9/30,141097,港北区,綱島東六丁目,92,0,0,0
2016/9/30,141097,港北区,綱島東六丁目,93,0,0,0
2016/9/30,141097,港北区,綱島東六丁目,94,2,0,2
2016/9/30,141097,港北区,綱島東六丁目,95,0,0,0
2016/9/30,141097,港北区,綱島東六丁目,96,0,0,0
2016/9/30,141097,港北区,綱島東六丁目,97,0,0,0
2016/9/30,141097,港北区,綱島東六丁目,98,0,0,0
2016/9/30,141097,港北区,綱島東六丁目,99,0,0,0
2016/9/30,141097,港北区,綱島東六丁目,100,0,0,0
2016/9/30,141097,港北区,綱島上町,合計,4405,2133,2272
2016/9/30,141097,港北区,綱島上町,0,28,14,14
2016/9/30,141097,港北区,綱島上町,1,47,21,26
2016/9/30,141097,港北区,綱島上町,2,29,13,16
2016/9/30,141097,港北区,綱島上町,3,48,25,23
2016/9/30,141097,港北区,綱島上町,4,45,15,30
2016/9/30,141097,港北区,綱島上町,5,38,25,13
2016/9/30,141097,港北区,綱島上町,6,40,25,15
2016/9/30,141097,港北区,綱島上町,7,50,21,29
2016/9/30,141097,港北区,綱島上町,8,53,26,27
2016/9/30,141097,港北区,綱島上町,9,48,22,26
2016/9/30,141097,港北区,綱島上町,10,65,36,29
2016/9/30,141097,港北区,綱島上町,11,70,31,39
2016/9/30,141097,港北区,綱島上町,12,62,36,26
2016/9/30,141097,港北区,綱島上町,13,65,31,34
2016/9/30,141097,港北区,綱島上町,14,79,36,43
2016/9/30,141097,港北区,綱島上町,15,77,39,38
2016/9/30,141097,港北区,綱島上町,16,69,40,29
2016/9/30,141097,港北区,綱島上町,17,54,22,32
2016/9/30,141097,港北区,綱島上町,18,66,36,30
2016/9/30,141097,港北区,綱島上町,19,54,31,23
2016/9/30,141097,港北区,綱島上町,20,44,20,24
2016/9/30,141097,港北区,綱島上町,21,46,23,23
2016/9/30,141097,港北区,綱島上町,22,28,14,14
2016/9/30,141097,港北区,綱島上町,23,37,11,26
2016/9/30,141097,港北区,綱島上町,24,40,19,21
2016/9/30,141097,港北区,綱島上町,25,32,20,12
2016/9/30,141097,港北区,綱島上町,26,33,13,20
2016/9/30,141097,港北区,綱島上町,27,33,14,19
2016/9/30,141097,港北区,綱島上町,28,41,18,23
2016/9/30,141097,港北区,綱島上町,29,37,18,19
2016/9/30,141097,港北区,綱島上町,30,44,24,20
2016/9/30,141097,港北区,綱島上町,31,30,17,13
2016/9/30,141097,港北区,綱島上町,32,55,24,31
2016/9/30,141097,港北区,綱島上町,33,51,23,28
2016/9/30,141097,港北区,綱島上町,34,53,24,29
2016/9/30,141097,港北区,綱島上町,35,37,13,24
2016/9/30,141097,港北区,綱島上町,36,66,45,21
2016/9/30,141097,港北区,綱島上町,37,57,24,33
2016/9/30,141097,港北区,綱島上町,38,65,31,34
2016/9/30,141097,港北区,綱島上町,39,76,30,46
2016/9/30,141097,港北区,綱島上町,40,78,38,40
2016/9/30,141097,港北区,綱島上町,41,76,34,42
2016/9/30,141097,港北区,綱島上町,42,71,33,38
2016/9/30,141097,港北区,綱島上町,43,84,40,44
2016/9/30,141097,港北区,綱島上町,44,93,43,50
2016/9/30,141097,港北区,綱島上町,45,108,47,61
2016/9/30,141097,港北区,綱島上町,46,117,52,65
2016/9/30,141097,港北区,綱島上町,47,123,54,69
2016/9/30,141097,港北区,綱島上町,48,95,45,50
2016/9/30,141097,港北区,綱島上町,49,119,62,57
2016/9/30,141097,港北区,綱島上町,50,82,46,36
2016/9/30,141097,港北区,綱島上町,51,95,48,47
2016/9/30,141097,港北区,綱島上町,52,90,42,48
2016/9/30,141097,港北区,綱島上町,53,82,41,41
2016/9/30,141097,港北区,綱島上町,54,77,43,34
2016/9/30,141097,港北区,綱島上町,55,68,36,32
2016/9/30,141097,港北区,綱島上町,56,79,35,44
2016/9/30,141097,港北区,綱島上町,57,59,37,22
2016/9/30,141097,港北区,綱島上町,58,42,24,18
2016/9/30,141097,港北区,綱島上町,59,26,15,11
2016/9/30,141097,港北区,綱島上町,60,43,17,26
2016/9/30,141097,港北区,綱島上町,61,34,20,14
2016/9/30,141097,港北区,綱島上町,62,32,14,18
2016/9/30,141097,港北区,綱島上町,63,44,20,24
2016/9/30,141097,港北区,綱島上町,64,43,24,19
2016/9/30,141097,港北区,綱島上町,65,30,15,15
2016/9/30,141097,港北区,綱島上町,66,46,21,25
2016/9/30,141097,港北区,綱島上町,67,50,25,25
2016/9/30,141097,港北区,綱島上町,68,44,23,21
2016/9/30,141097,港北区,綱島上町,69,33,16,17
2016/9/30,141097,港北区,綱島上町,70,26,11,15
2016/9/30,141097,港北区,綱島上町,71,29,11,18
2016/9/30,141097,港北区,綱島上町,72,27,19,8
2016/9/30,141097,港北区,綱島上町,73,23,10,13
2016/9/30,141097,港北区,綱島上町,74,23,11,12
2016/9/30,141097,港北区,綱島上町,75,29,16,13
2016/9/30,141097,港北区,綱島上町,76,18,5,13
2016/9/30,141097,港北区,綱島上町,77,15,7,8
2016/9/30,141097,港北区,綱島上町,78,14,5,9
2016/9/30,141097,港北区,綱島上町,79,19,10,9
2016/9/30,141097,港北区,綱島上町,80,19,9,10
2016/9/30,141097,港北区,綱島上町,81,16,6,10
2016/9/30,141097,港北区,綱島上町,82,13,4,9
2016/9/30,141097,港北区,綱島上町,83,12,5,7
2016/9/30,141097,港北区,綱島上町,84,12,2,10
2016/9/30,141097,港北区,綱島上町,85,8,4,4
2016/9/30,141097,港北区,綱島上町,86,9,3,6
2016/9/30,141097,港北区,綱島上町,87,10,6,4
2016/9/30,141097,港北区,綱島上町,88,9,4,5
2016/9/30,141097,港北区,綱島上町,89,7,3,4
2016/9/30,141097,港北区,綱島上町,90,2,1,1
2016/9/30,141097,港北区,綱島上町,91,1,0,1
2016/9/30,141097,港北区,綱島上町,92,2,1,1
2016/9/30,141097,港北区,綱島上町,93,1,0,1
2016/9/30,141097,港北区,綱島上町,94,2,0,2
2016/9/30,141097,港北区,綱島上町,95,1,0,1
2016/9/30,141097,港北区,綱島上町,96,1,0,1
2016/9/30,141097,港北区,綱島上町,97,1,0,1
2016/9/30,141097,港北区,綱島上町,98,0,0,0
2016/9/30,141097,港北区,綱島上町,99,1,0,1
2016/9/30,141097,港北区,綱島上町,100,0,0,0
2016/9/30,141097,港北区,綱島台,合計,2164,1113,1051
2016/9/30,141097,港北区,綱島台,0,23,7,16
2016/9/30,141097,港北区,綱島台,1,19,11,8
2016/9/30,141097,港北区,綱島台,2,20,10,10
2016/9/30,141097,港北区,綱島台,3,24,13,11
2016/9/30,141097,港北区,綱島台,4,14,7,7
2016/9/30,141097,港北区,綱島台,5,20,13,7
2016/9/30,141097,港北区,綱島台,6,16,11,5
2016/9/30,141097,港北区,綱島台,7,15,4,11
2016/9/30,141097,港北区,綱島台,8,15,9,6
2016/9/30,141097,港北区,綱島台,9,11,8,3
2016/9/30,141097,港北区,綱島台,10,10,4,6
2016/9/30,141097,港北区,綱島台,11,16,9,7
2016/9/30,141097,港北区,綱島台,12,6,5,1
2016/9/30,141097,港北区,綱島台,13,10,4,6
2016/9/30,141097,港北区,綱島台,14,13,6,7
2016/9/30,141097,港北区,綱島台,15,11,5,6
2016/9/30,141097,港北区,綱島台,16,11,4,7
2016/9/30,141097,港北区,綱島台,17,12,3,9
2016/9/30,141097,港北区,綱島台,18,13,6,7
2016/9/30,141097,港北区,綱島台,19,13,6,7
2016/9/30,141097,港北区,綱島台,20,18,7,11
2016/9/30,141097,港北区,綱島台,21,22,11,11
2016/9/30,141097,港北区,綱島台,22,27,12,15
2016/9/30,141097,港北区,綱島台,23,38,23,15
2016/9/30,141097,港北区,綱島台,24,38,27,11
2016/9/30,141097,港北区,綱島台,25,48,34,14
2016/9/30,141097,港北区,綱島台,26,40,26,14
2016/9/30,141097,港北区,綱島台,27,29,13,16
2016/9/30,141097,港北区,綱島台,28,40,21,19
2016/9/30,141097,港北区,綱島台,29,43,19,24
2016/9/30,141097,港北区,綱島台,30,35,18,17
2016/9/30,141097,港北区,綱島台,31,40,26,14
2016/9/30,141097,港北区,綱島台,32,35,23,12
2016/9/30,141097,港北区,綱島台,33,37,21,16
2016/9/30,141097,港北区,綱島台,34,39,23,16
2016/9/30,141097,港北区,綱島台,35,31,16,15
2016/9/30,141097,港北区,綱島台,36,37,13,24
2016/9/30,141097,港北区,綱島台,37,39,15,24
2016/9/30,141097,港北区,綱島台,38,33,17,16
2016/9/30,141097,港北区,綱島台,39,34,19,15
2016/9/30,141097,港北区,綱島台,40,31,21,10
2016/9/30,141097,港北区,綱島台,41,41,15,26
2016/9/30,141097,港北区,綱島台,42,38,24,14
2016/9/30,141097,港北区,綱島台,43,33,17,16
2016/9/30,141097,港北区,綱島台,44,47,27,20
2016/9/30,141097,港北区,綱島台,45,31,17,14
2016/9/30,141097,港北区,綱島台,46,37,22,15
2016/9/30,141097,港北区,綱島台,47,43,26,17
2016/9/30,141097,港北区,綱島台,48,32,18,14
2016/9/30,141097,港北区,綱島台,49,32,19,13
2016/9/30,141097,港北区,綱島台,50,20,8,12
2016/9/30,141097,港北区,綱島台,51,34,20,14
2016/9/30,141097,港北区,綱島台,52,21,13,8
2016/9/30,141097,港北区,綱島台,53,26,13,13
2016/9/30,141097,港北区,綱島台,54,31,11,20
2016/9/30,141097,港北区,綱島台,55,17,10,7
2016/9/30,141097,港北区,綱島台,56,25,13,12
2016/9/30,141097,港北区,綱島台,57,15,6,9
2016/9/30,141097,港北区,綱島台,58,24,10,14
2016/9/30,141097,港北区,綱島台,59,26,18,8
2016/9/30,141097,港北区,綱島台,60,26,17,9
2016/9/30,141097,港北区,綱島台,61,26,9,17
2016/9/30,141097,港北区,綱島台,62,27,13,14
2016/9/30,141097,港北区,綱島台,63,22,15,7
2016/9/30,141097,港北区,綱島台,64,30,16,14
2016/9/30,141097,港北区,綱島台,65,24,15,9
2016/9/30,141097,港北区,綱島台,66,29,9,20
2016/9/30,141097,港北区,綱島台,67,31,18,13
2016/9/30,141097,港北区,綱島台,68,24,16,8
2016/9/30,141097,港北区,綱島台,69,32,12,20
2016/9/30,141097,港北区,綱島台,70,20,9,11
2016/9/30,141097,港北区,綱島台,71,27,12,15
2016/9/30,141097,港北区,綱島台,72,21,8,13
2016/9/30,141097,港北区,綱島台,73,18,12,6
2016/9/30,141097,港北区,綱島台,74,17,7,10
2016/9/30,141097,港北区,綱島台,75,13,2,11
2016/9/30,141097,港北区,綱島台,76,17,8,9
2016/9/30,141097,港北区,綱島台,77,10,3,7
2016/9/30,141097,港北区,綱島台,78,20,9,11
2016/9/30,141097,港北区,綱島台,79,17,9,8
2016/9/30,141097,港北区,綱島台,80,11,5,6
2016/9/30,141097,港北区,綱島台,81,11,5,6
2016/9/30,141097,港北区,綱島台,82,13,5,8
2016/9/30,141097,港北区,綱島台,83,13,5,8
2016/9/30,141097,港北区,綱島台,84,12,2,10
2016/9/30,141097,港北区,綱島台,85,6,2,4
2016/9/30,141097,港北区,綱島台,86,8,1,7
2016/9/30,141097,港北区,綱島台,87,4,0,4
2016/9/30,141097,港北区,綱島台,88,1,0,1
2016/9/30,141097,港北区,綱島台,89,4,1,3
2016/9/30,141097,港北区,綱島台,90,7,2,5
2016/9/30,141097,港北区,綱島台,91,3,1,2
2016/9/30,141097,港北区,綱島台,92,5,3,2
2016/9/30,141097,港北区,綱島台,93,5,2,3
2016/9/30,141097,港北区,綱島台,94,1,1,0
2016/9/30,141097,港北区,綱島台,95,4,1,3
2016/9/30,141097,港北区,綱島台,96,2,1,1
2016/9/30,141097,港北区,綱島台,97,1,0,1
2016/9/30,141097,港北区,綱島台,98,1,0,1
2016/9/30,141097,港北区,綱島台,99,2,0,2
2016/9/30,141097,港北区,綱島台,100,0,0,0
2016/9/30,141097,港北区,綱島西一丁目,合計,1941,931,1010
2016/9/30,141097,港北区,綱島西一丁目,0,17,9,8
2016/9/30,141097,港北区,綱島西一丁目,1,16,9,7
2016/9/30,141097,港北区,綱島西一丁目,2,12,7,5
2016/9/30,141097,港北区,綱島西一丁目,3,15,8,7
2016/9/30,141097,港北区,綱島西一丁目,4,10,5,5
2016/9/30,141097,港北区,綱島西一丁目,5,10,4,6
2016/9/30,141097,港北区,綱島西一丁目,6,12,8,4
2016/9/30,141097,港北区,綱島西一丁目,7,8,5,3
2016/9/30,141097,港北区,綱島西一丁目,8,5,2,3
2016/9/30,141097,港北区,綱島西一丁目,9,14,6,8
2016/9/30,141097,港北区,綱島西一丁目,10,10,6,4
2016/9/30,141097,港北区,綱島西一丁目,11,14,8,6
2016/9/30,141097,港北区,綱島西一丁目,12,11,6,5
2016/9/30,141097,港北区,綱島西一丁目,13,6,3,3
2016/9/30,141097,港北区,綱島西一丁目,14,7,2,5
2016/9/30,141097,港北区,綱島西一丁目,15,9,4,5
2016/9/30,141097,港北区,綱島西一丁目,16,10,2,8
2016/9/30,141097,港北区,綱島西一丁目,17,7,4,3
2016/9/30,141097,港北区,綱島西一丁目,18,11,5,6
2016/9/30,141097,港北区,綱島西一丁目,19,14,5,9
2016/9/30,141097,港北区,綱島西一丁目,20,20,8,12
2016/9/30,141097,港北区,綱島西一丁目,21,26,10,16
2016/9/30,141097,港北区,綱島西一丁目,22,29,16,13
2016/9/30,141097,港北区,綱島西一丁目,23,34,19,15
2016/9/30,141097,港北区,綱島西一丁目,24,18,8,10
2016/9/30,141097,港北区,綱島西一丁目,25,29,12,17
2016/9/30,141097,港北区,綱島西一丁目,26,38,21,17
2016/9/30,141097,港北区,綱島西一丁目,27,36,21,15
2016/9/30,141097,港北区,綱島西一丁目,28,22,12,10
2016/9/30,141097,港北区,綱島西一丁目,29,32,23,9
2016/9/30,141097,港北区,綱島西一丁目,30,47,18,29
2016/9/30,141097,港北区,綱島西一丁目,31,29,15,14
2016/9/30,141097,港北区,綱島西一丁目,32,33,22,11
2016/9/30,141097,港北区,綱島西一丁目,33,23,9,14
2016/9/30,141097,港北区,綱島西一丁目,34,26,14,12
2016/9/30,141097,港北区,綱島西一丁目,35,34,19,15
2016/9/30,141097,港北区,綱島西一丁目,36,27,15,12
2016/9/30,141097,港北区,綱島西一丁目,37,30,17,13
2016/9/30,141097,港北区,綱島西一丁目,38,32,13,19
2016/9/30,141097,港北区,綱島西一丁目,39,30,17,13
2016/9/30,141097,港北区,綱島西一丁目,40,26,17,9
2016/9/30,141097,港北区,綱島西一丁目,41,42,20,22
2016/9/30,141097,港北区,綱島西一丁目,42,33,12,21
2016/9/30,141097,港北区,綱島西一丁目,43,47,23,24
2016/9/30,141097,港北区,綱島西一丁目,44,28,12,16
2016/9/30,141097,港北区,綱島西一丁目,45,32,12,20
2016/9/30,141097,港北区,綱島西一丁目,46,34,23,11
2016/9/30,141097,港北区,綱島西一丁目,47,35,13,22
2016/9/30,141097,港北区,綱島西一丁目,48,25,10,15
2016/9/30,141097,港北区,綱島西一丁目,49,32,18,14
2016/9/30,141097,港北区,綱島西一丁目,50,21,11,10
2016/9/30,141097,港北区,綱島西一丁目,51,24,8,16
2016/9/30,141097,港北区,綱島西一丁目,52,31,15,16
2016/9/30,141097,港北区,綱島西一丁目,53,25,12,13
2016/9/30,141097,港北区,綱島西一丁目,54,18,10,8
2016/9/30,141097,港北区,綱島西一丁目,55,21,11,10
2016/9/30,141097,港北区,綱島西一丁目,56,19,12,7
2016/9/30,141097,港北区,綱島西一丁目,57,14,6,8
2016/9/30,141097,港北区,綱島西一丁目,58,34,11,23
2016/9/30,141097,港北区,綱島西一丁目,59,19,8,11
2016/9/30,141097,港北区,綱島西一丁目,60,18,8,10
2016/9/30,141097,港北区,綱島西一丁目,61,12,6,6
2016/9/30,141097,港北区,綱島西一丁目,62,18,13,5
2016/9/30,141097,港北区,綱島西一丁目,63,22,12,10
2016/9/30,141097,港北区,綱島西一丁目,64,23,8,15
2016/9/30,141097,港北区,綱島西一丁目,65,33,16,17
2016/9/30,141097,港北区,綱島西一丁目,66,28,12,16
2016/9/30,141097,港北区,綱島西一丁目,67,27,19,8
2016/9/30,141097,港北区,綱島西一丁目,68,28,11,17
2016/9/30,141097,港北区,綱島西一丁目,69,25,10,15
2016/9/30,141097,港北区,綱島西一丁目,70,23,12,11
2016/9/30,141097,港北区,綱島西一丁目,71,13,8,5
2016/9/30,141097,港北区,綱島西一丁目,72,19,7,12
2016/9/30,141097,港北区,綱島西一丁目,73,14,6,8
2016/9/30,141097,港北区,綱島西一丁目,74,23,9,14
2016/9/30,141097,港北区,綱島西一丁目,75,20,8,12
2016/9/30,141097,港北区,綱島西一丁目,76,14,7,7
2016/9/30,141097,港北区,綱島西一丁目,77,13,4,9
2016/9/30,141097,港北区,綱島西一丁目,78,16,6,10
2016/9/30,141097,港北区,綱島西一丁目,79,14,6,8
2016/9/30,141097,港北区,綱島西一丁目,80,9,4,5
2016/9/30,141097,港北区,綱島西一丁目,81,14,5,9
2016/9/30,141097,港北区,綱島西一丁目,82,15,7,8
2016/9/30,141097,港北区,綱島西一丁目,83,16,8,8
2016/9/30,141097,港北区,綱島西一丁目,84,20,10,10
2016/9/30,141097,港北区,綱島西一丁目,85,12,7,5
2016/9/30,141097,港北区,綱島西一丁目,86,12,2,10
2016/9/30,141097,港北区,綱島西一丁目,87,13,4,9
2016/9/30,141097,港北区,綱島西一丁目,88,12,4,8
2016/9/30,141097,港北区,綱島西一丁目,89,11,5,6
2016/9/30,141097,港北区,綱島西一丁目,90,9,2,7
2016/9/30,141097,港北区,綱島西一丁目,91,6,1,5
2016/9/30,141097,港北区,綱島西一丁目,92,9,1,8
2016/9/30,141097,港北区,綱島西一丁目,93,2,2,0
2016/9/30,141097,港北区,綱島西一丁目,94,1,0,1
2016/9/30,141097,港北区,綱島西一丁目,95,1,0,1
2016/9/30,141097,港北区,綱島西一丁目,96,1,0,1
2016/9/30,141097,港北区,綱島西一丁目,97,0,0,0
2016/9/30,141097,港北区,綱島西一丁目,98,0,0,0
2016/9/30,141097,港北区,綱島西一丁目,99,0,0,0
2016/9/30,141097,港北区,綱島西一丁目,100,2,0,2
2016/9/30,141097,港北区,綱島西二丁目,合計,3989,1969,2020
2016/9/30,141097,港北区,綱島西二丁目,0,49,28,21
2016/9/30,141097,港北区,綱島西二丁目,1,46,25,21
2016/9/30,141097,港北区,綱島西二丁目,2,39,20,19
2016/9/30,141097,港北区,綱島西二丁目,3,33,19,14
2016/9/30,141097,港北区,綱島西二丁目,4,24,11,13
2016/9/30,141097,港北区,綱島西二丁目,5,29,18,11
2016/9/30,141097,港北区,綱島西二丁目,6,19,12,7
2016/9/30,141097,港北区,綱島西二丁目,7,21,12,9
2016/9/30,141097,港北区,綱島西二丁目,8,19,11,8
2016/9/30,141097,港北区,綱島西二丁目,9,16,8,8
2016/9/30,141097,港北区,綱島西二丁目,10,17,8,9
2016/9/30,141097,港北区,綱島西二丁目,11,18,7,11
2016/9/30,141097,港北区,綱島西二丁目,12,16,9,7
2016/9/30,141097,港北区,綱島西二丁目,13,20,9,11
2016/9/30,141097,港北区,綱島西二丁目,14,18,11,7
2016/9/30,141097,港北区,綱島西二丁目,15,17,10,7
2016/9/30,141097,港北区,綱島西二丁目,16,17,9,8
2016/9/30,141097,港北区,綱島西二丁目,17,12,9,3
2016/9/30,141097,港北区,綱島西二丁目,18,31,12,19
2016/9/30,141097,港北区,綱島西二丁目,19,35,15,20
2016/9/30,141097,港北区,綱島西二丁目,20,40,18,22
2016/9/30,141097,港北区,綱島西二丁目,21,41,20,21
2016/9/30,141097,港北区,綱島西二丁目,22,43,19,24
2016/9/30,141097,港北区,綱島西二丁目,23,51,17,34
2016/9/30,141097,港北区,綱島西二丁目,24,80,42,38
2016/9/30,141097,港北区,綱島西二丁目,25,63,27,36
2016/9/30,141097,港北区,綱島西二丁目,26,100,49,51
2016/9/30,141097,港北区,綱島西二丁目,27,72,32,40
2016/9/30,141097,港北区,綱島西二丁目,28,65,35,30
2016/9/30,141097,港北区,綱島西二丁目,29,70,39,31
2016/9/30,141097,港北区,綱島西二丁目,30,86,40,46
2016/9/30,141097,港北区,綱島西二丁目,31,96,46,50
2016/9/30,141097,港北区,綱島西二丁目,32,89,47,42
2016/9/30,141097,港北区,綱島西二丁目,33,92,48,44
2016/9/30,141097,港北区,綱島西二丁目,34,85,49,36
2016/9/30,141097,港北区,綱島西二丁目,35,88,48,40
2016/9/30,141097,港北区,綱島西二丁目,36,88,51,37
2016/9/30,141097,港北区,綱島西二丁目,37,92,55,37
2016/9/30,141097,港北区,綱島西二丁目,38,82,39,43
2016/9/30,141097,港北区,綱島西二丁目,39,63,36,27
2016/9/30,141097,港北区,綱島西二丁目,40,71,35,36
2016/9/30,141097,港北区,綱島西二丁目,41,86,39,47
2016/9/30,141097,港北区,綱島西二丁目,42,83,38,45
2016/9/30,141097,港北区,綱島西二丁目,43,71,33,38
2016/9/30,141097,港北区,綱島西二丁目,44,70,34,36
2016/9/30,141097,港北区,綱島西二丁目,45,64,38,26
2016/9/30,141097,港北区,綱島西二丁目,46,57,28,29
2016/9/30,141097,港北区,綱島西二丁目,47,63,35,28
2016/9/30,141097,港北区,綱島西二丁目,48,61,26,35
2016/9/30,141097,港北区,綱島西二丁目,49,60,30,30
2016/9/30,141097,港北区,綱島西二丁目,50,39,15,24
2016/9/30,141097,港北区,綱島西二丁目,51,48,21,27
2016/9/30,141097,港北区,綱島西二丁目,52,63,34,29
2016/9/30,141097,港北区,綱島西二丁目,53,66,34,32
2016/9/30,141097,港北区,綱島西二丁目,54,47,25,22
2016/9/30,141097,港北区,綱島西二丁目,55,53,25,28
2016/9/30,141097,港北区,綱島西二丁目,56,47,25,22
2016/9/30,141097,港北区,綱島西二丁目,57,35,21,14
2016/9/30,141097,港北区,綱島西二丁目,58,48,24,24
2016/9/30,141097,港北区,綱島西二丁目,59,25,13,12
2016/9/30,141097,港北区,綱島西二丁目,60,46,25,21
2016/9/30,141097,港北区,綱島西二丁目,61,35,19,16
2016/9/30,141097,港北区,綱島西二丁目,62,29,13,16
2016/9/30,141097,港北区,綱島西二丁目,63,40,16,24
2016/9/30,141097,港北区,綱島西二丁目,64,30,13,17
2016/9/30,141097,港北区,綱島西二丁目,65,42,21,21
2016/9/30,141097,港北区,綱島西二丁目,66,50,24,26
2016/9/30,141097,港北区,綱島西二丁目,67,56,30,26
2016/9/30,141097,港北区,綱島西二丁目,68,59,25,34
2016/9/30,141097,港北区,綱島西二丁目,69,42,17,25
2016/9/30,141097,港北区,綱島西二丁目,70,28,11,17
2016/9/30,141097,港北区,綱島西二丁目,71,25,13,12
2016/9/30,141097,港北区,綱島西二丁目,72,37,11,26
2016/9/30,141097,港北区,綱島西二丁目,73,33,21,12
2016/9/30,141097,港北区,綱島西二丁目,74,37,15,22
2016/9/30,141097,港北区,綱島西二丁目,75,21,12,9
2016/9/30,141097,港北区,綱島西二丁目,76,25,8,17
2016/9/30,141097,港北区,綱島西二丁目,77,22,6,16
2016/9/30,141097,港北区,綱島西二丁目,78,15,6,9
2016/9/30,141097,港北区,綱島西二丁目,79,19,7,12
2016/9/30,141097,港北区,綱島西二丁目,80,15,7,8
2016/9/30,141097,港北区,綱島西二丁目,81,11,5,6
2016/9/30,141097,港北区,綱島西二丁目,82,19,6,13
2016/9/30,141097,港北区,綱島西二丁目,83,18,8,10
2016/9/30,141097,港北区,綱島西二丁目,84,19,4,15
2016/9/30,141097,港北区,綱島西二丁目,85,21,10,11
2016/9/30,141097,港北区,綱島西二丁目,86,15,5,10
2016/9/30,141097,港北区,綱島西二丁目,87,9,3,6
2016/9/30,141097,港北区,綱島西二丁目,88,5,3,2
2016/9/30,141097,港北区,綱島西二丁目,89,4,2,2
2016/9/30,141097,港北区,綱島西二丁目,90,6,2,4
2016/9/30,141097,港北区,綱島西二丁目,91,4,2,2
2016/9/30,141097,港北区,綱島西二丁目,92,3,1,2
2016/9/30,141097,港北区,綱島西二丁目,93,4,2,2
2016/9/30,141097,港北区,綱島西二丁目,94,3,2,1
2016/9/30,141097,港北区,綱島西二丁目,95,0,0,0
2016/9/30,141097,港北区,綱島西二丁目,96,0,0,0
2016/9/30,141097,港北区,綱島西二丁目,97,2,0,2
2016/9/30,141097,港北区,綱島西二丁目,98,1,1,0
2016/9/30,141097,港北区,綱島西二丁目,99,0,0,0
2016/9/30,141097,港北区,綱島西二丁目,100,0,0,0
2016/9/30,141097,港北区,綱島西三丁目,合計,2159,1084,1075
2016/9/30,141097,港北区,綱島西三丁目,0,21,7,14
2016/9/30,141097,港北区,綱島西三丁目,1,25,13,12
2016/9/30,141097,港北区,綱島西三丁目,2,23,14,9
2016/9/30,141097,港北区,綱島西三丁目,3,26,17,9
2016/9/30,141097,港北区,綱島西三丁目,4,15,5,10
2016/9/30,141097,港北区,綱島西三丁目,5,20,8,12
2016/9/30,141097,港北区,綱島西三丁目,6,17,6,11
2016/9/30,141097,港北区,綱島西三丁目,7,15,9,6
2016/9/30,141097,港北区,綱島西三丁目,8,14,6,8
2016/9/30,141097,港北区,綱島西三丁目,9,14,9,5
2016/9/30,141097,港北区,綱島西三丁目,10,11,5,6
2016/9/30,141097,港北区,綱島西三丁目,11,13,7,6
2016/9/30,141097,港北区,綱島西三丁目,12,14,6,8
2016/9/30,141097,港北区,綱島西三丁目,13,8,5,3
2016/9/30,141097,港北区,綱島西三丁目,14,9,3,6
2016/9/30,141097,港北区,綱島西三丁目,15,16,9,7
2016/9/30,141097,港北区,綱島西三丁目,16,4,2,2
2016/9/30,141097,港北区,綱島西三丁目,17,14,10,4
2016/9/30,141097,港北区,綱島西三丁目,18,13,6,7
2016/9/30,141097,港北区,綱島西三丁目,19,14,6,8
2016/9/30,141097,港北区,綱島西三丁目,20,16,6,10
2016/9/30,141097,港北区,綱島西三丁目,21,18,10,8
2016/9/30,141097,港北区,綱島西三丁目,22,24,11,13
2016/9/30,141097,港北区,綱島西三丁目,23,23,13,10
2016/9/30,141097,港北区,綱島西三丁目,24,33,13,20
2016/9/30,141097,港北区,綱島西三丁目,25,32,20,12
2016/9/30,141097,港北区,綱島西三丁目,26,40,20,20
2016/9/30,141097,港北区,綱島西三丁目,27,40,26,14
2016/9/30,141097,港北区,綱島西三丁目,28,51,23,28
2016/9/30,141097,港北区,綱島西三丁目,29,61,30,31
2016/9/30,141097,港北区,綱島西三丁目,30,50,20,30
2016/9/30,141097,港北区,綱島西三丁目,31,54,24,30
2016/9/30,141097,港北区,綱島西三丁目,32,51,30,21
2016/9/30,141097,港北区,綱島西三丁目,33,51,28,23
2016/9/30,141097,港北区,綱島西三丁目,34,45,23,22
2016/9/30,141097,港北区,綱島西三丁目,35,41,19,22
2016/9/30,141097,港北区,綱島西三丁目,36,35,20,15
2016/9/30,141097,港北区,綱島西三丁目,37,47,27,20
2016/9/30,141097,港北区,綱島西三丁目,38,39,18,21
2016/9/30,141097,港北区,綱島西三丁目,39,43,23,20
2016/9/30,141097,港北区,綱島西三丁目,40,45,27,18
2016/9/30,141097,港北区,綱島西三丁目,41,41,22,19
2016/9/30,141097,港北区,綱島西三丁目,42,28,16,12
2016/9/30,141097,港北区,綱島西三丁目,43,45,27,18
2016/9/30,141097,港北区,綱島西三丁目,44,37,17,20
2016/9/30,141097,港北区,綱島西三丁目,45,21,12,9
2016/9/30,141097,港北区,綱島西三丁目,46,27,14,13
2016/9/30,141097,港北区,綱島西三丁目,47,38,21,17
2016/9/30,141097,港北区,綱島西三丁目,48,31,19,12
2016/9/30,141097,港北区,綱島西三丁目,49,36,15,21
2016/9/30,141097,港北区,綱島西三丁目,50,21,11,10
2016/9/30,141097,港北区,綱島西三丁目,51,27,17,10
2016/9/30,141097,港北区,綱島西三丁目,52,27,18,9
2016/9/30,141097,港北区,綱島西三丁目,53,28,14,14
2016/9/30,141097,港北区,綱島西三丁目,54,16,7,9
2016/9/30,141097,港北区,綱島西三丁目,55,33,18,15
2016/9/30,141097,港北区,綱島西三丁目,56,17,12,5
2016/9/30,141097,港北区,綱島西三丁目,57,24,10,14
2016/9/30,141097,港北区,綱島西三丁目,58,14,9,5
2016/9/30,141097,港北区,綱島西三丁目,59,18,8,10
2016/9/30,141097,港北区,綱島西三丁目,60,16,10,6
2016/9/30,141097,港北区,綱島西三丁目,61,18,10,8
2016/9/30,141097,港北区,綱島西三丁目,62,15,9,6
2016/9/30,141097,港北区,綱島西三丁目,63,18,11,7
2016/9/30,141097,港北区,綱島西三丁目,64,18,9,9
2016/9/30,141097,港北区,綱島西三丁目,65,16,6,10
2016/9/30,141097,港北区,綱島西三丁目,66,13,9,4
2016/9/30,141097,港北区,綱島西三丁目,67,29,13,16
2016/9/30,141097,港北区,綱島西三丁目,68,30,17,13
2016/9/30,141097,港北区,綱島西三丁目,69,22,14,8
2016/9/30,141097,港北区,綱島西三丁目,70,10,5,5
2016/9/30,141097,港北区,綱島西三丁目,71,17,9,8
2016/9/30,141097,港北区,綱島西三丁目,72,20,8,12
2016/9/30,141097,港北区,綱島西三丁目,73,17,11,6
2016/9/30,141097,港北区,綱島西三丁目,74,13,5,8
2016/9/30,141097,港北区,綱島西三丁目,75,14,8,6
2016/9/30,141097,港北区,綱島西三丁目,76,9,5,4
2016/9/30,141097,港北区,綱島西三丁目,77,8,4,4
2016/9/30,141097,港北区,綱島西三丁目,78,14,5,9
2016/9/30,141097,港北区,綱島西三丁目,79,15,3,12
2016/9/30,141097,港北区,綱島西三丁目,80,18,5,13
2016/9/30,141097,港北区,綱島西三丁目,81,10,4,6
2016/9/30,141097,港北区,綱島西三丁目,82,10,4,6
2016/9/30,141097,港北区,綱島西三丁目,83,11,1,10
2016/9/30,141097,港北区,綱島西三丁目,84,11,5,6
2016/9/30,141097,港北区,綱島西三丁目,85,8,1,7
2016/9/30,141097,港北区,綱島西三丁目,86,7,1,6
2016/9/30,141097,港北区,綱島西三丁目,87,12,5,7
2016/9/30,141097,港北区,綱島西三丁目,88,6,2,4
2016/9/30,141097,港北区,綱島西三丁目,89,8,2,6
2016/9/30,141097,港北区,綱島西三丁目,90,10,3,7
2016/9/30,141097,港北区,綱島西三丁目,91,17,6,11
2016/9/30,141097,港北区,綱島西三丁目,92,3,1,2
2016/9/30,141097,港北区,綱島西三丁目,93,4,0,4
2016/9/30,141097,港北区,綱島西三丁目,94,4,0,4
2016/9/30,141097,港北区,綱島西三丁目,95,2,0,2
2016/9/30,141097,港北区,綱島西三丁目,96,1,0,1
2016/9/30,141097,港北区,綱島西三丁目,97,2,0,2
2016/9/30,141097,港北区,綱島西三丁目,98,5,0,5
2016/9/30,141097,港北区,綱島西三丁目,99,1,0,1
2016/9/30,141097,港北区,綱島西三丁目,100,3,2,1
2016/9/30,141097,港北区,綱島西四丁目,合計,2932,1521,1411
2016/9/30,141097,港北区,綱島西四丁目,0,63,40,23
2016/9/30,141097,港北区,綱島西四丁目,1,35,17,18
2016/9/30,141097,港北区,綱島西四丁目,2,40,21,19
2016/9/30,141097,港北区,綱島西四丁目,3,36,20,16
2016/9/30,141097,港北区,綱島西四丁目,4,29,18,11
2016/9/30,141097,港北区,綱島西四丁目,5,18,11,7
2016/9/30,141097,港北区,綱島西四丁目,6,14,7,7
2016/9/30,141097,港北区,綱島西四丁目,7,18,12,6
2016/9/30,141097,港北区,綱島西四丁目,8,14,10,4
2016/9/30,141097,港北区,綱島西四丁目,9,18,6,12
2016/9/30,141097,港北区,綱島西四丁目,10,17,10,7
2016/9/30,141097,港北区,綱島西四丁目,11,16,9,7
2016/9/30,141097,港北区,綱島西四丁目,12,7,3,4
2016/9/30,141097,港北区,綱島西四丁目,13,15,5,10
2016/9/30,141097,港北区,綱島西四丁目,14,16,6,10
2016/9/30,141097,港北区,綱島西四丁目,15,12,9,3
2016/9/30,141097,港北区,綱島西四丁目,16,19,9,10
2016/9/30,141097,港北区,綱島西四丁目,17,17,11,6
2016/9/30,141097,港北区,綱島西四丁目,18,28,16,12
2016/9/30,141097,港北区,綱島西四丁目,19,18,10,8
2016/9/30,141097,港北区,綱島西四丁目,20,28,16,12
2016/9/30,141097,港北区,綱島西四丁目,21,23,14,9
2016/9/30,141097,港北区,綱島西四丁目,22,28,12,16
2016/9/30,141097,港北区,綱島西四丁目,23,31,13,18
2016/9/30,141097,港北区,綱島西四丁目,24,48,23,25
2016/9/30,141097,港北区,綱島西四丁目,25,48,29,19
2016/9/30,141097,港北区,綱島西四丁目,26,55,27,28
2016/9/30,141097,港北区,綱島西四丁目,27,58,25,33
2016/9/30,141097,港北区,綱島西四丁目,28,58,22,36
2016/9/30,141097,港北区,綱島西四丁目,29,65,37,28
2016/9/30,141097,港北区,綱島西四丁目,30,74,39,35
2016/9/30,141097,港北区,綱島西四丁目,31,78,41,37
2016/9/30,141097,港北区,綱島西四丁目,32,81,40,41
2016/9/30,141097,港北区,綱島西四丁目,33,68,31,37
2016/9/30,141097,港北区,綱島西四丁目,34,73,40,33
2016/9/30,141097,港北区,綱島西四丁目,35,61,29,32
2016/9/30,141097,港北区,綱島西四丁目,36,50,23,27
2016/9/30,141097,港北区,綱島西四丁目,37,60,33,27
2016/9/30,141097,港北区,綱島西四丁目,38,75,46,29
2016/9/30,141097,港北区,綱島西四丁目,39,57,32,25
2016/9/30,141097,港北区,綱島西四丁目,40,62,26,36
2016/9/30,141097,港北区,綱島西四丁目,41,53,39,14
2016/9/30,141097,港北区,綱島西四丁目,42,55,29,26
2016/9/30,141097,港北区,綱島西四丁目,43,52,29,23
2016/9/30,141097,港北区,綱島西四丁目,44,54,30,24
2016/9/30,141097,港北区,綱島西四丁目,45,48,26,22
2016/9/30,141097,港北区,綱島西四丁目,46,49,25,24
2016/9/30,141097,港北区,綱島西四丁目,47,43,20,23
2016/9/30,141097,港北区,綱島西四丁目,48,34,17,17
2016/9/30,141097,港北区,綱島西四丁目,49,43,28,15
2016/9/30,141097,港北区,綱島西四丁目,50,27,13,14
2016/9/30,141097,港北区,綱島西四丁目,51,29,14,15
2016/9/30,141097,港北区,綱島西四丁目,52,36,20,16
2016/9/30,141097,港北区,綱島西四丁目,53,34,19,15
2016/9/30,141097,港北区,綱島西四丁目,54,30,15,15
2016/9/30,141097,港北区,綱島西四丁目,55,40,23,17
2016/9/30,141097,港北区,綱島西四丁目,56,33,19,14
2016/9/30,141097,港北区,綱島西四丁目,57,31,16,15
2016/9/30,141097,港北区,綱島西四丁目,58,24,8,16
2016/9/30,141097,港北区,綱島西四丁目,59,16,7,9
2016/9/30,141097,港北区,綱島西四丁目,60,29,16,13
2016/9/30,141097,港北区,綱島西四丁目,61,25,15,10
2016/9/30,141097,港北区,綱島西四丁目,62,28,9,19
2016/9/30,141097,港北区,綱島西四丁目,63,22,13,9
2016/9/30,141097,港北区,綱島西四丁目,64,22,15,7
2016/9/30,141097,港北区,綱島西四丁目,65,33,21,12
2016/9/30,141097,港北区,綱島西四丁目,66,34,18,16
2016/9/30,141097,港北区,綱島西四丁目,67,26,13,13
2016/9/30,141097,港北区,綱島西四丁目,68,31,18,13
2016/9/30,141097,港北区,綱島西四丁目,69,19,9,10
2016/9/30,141097,港北区,綱島西四丁目,70,17,10,7
2016/9/30,141097,港北区,綱島西四丁目,71,28,12,16
2016/9/30,141097,港北区,綱島西四丁目,72,20,9,11
2016/9/30,141097,港北区,綱島西四丁目,73,15,5,10
2016/9/30,141097,港北区,綱島西四丁目,74,20,8,12
2016/9/30,141097,港北区,綱島西四丁目,75,14,3,11
2016/9/30,141097,港北区,綱島西四丁目,76,28,16,12
2016/9/30,141097,港北区,綱島西四丁目,77,14,10,4
2016/9/30,141097,港北区,綱島西四丁目,78,13,4,9
2016/9/30,141097,港北区,綱島西四丁目,79,10,7,3
2016/9/30,141097,港北区,綱島西四丁目,80,12,4,8
2016/9/30,141097,港北区,綱島西四丁目,81,17,6,11
2016/9/30,141097,港北区,綱島西四丁目,82,11,4,7
2016/9/30,141097,港北区,綱島西四丁目,83,17,9,8
2016/9/30,141097,港北区,綱島西四丁目,84,13,4,9
2016/9/30,141097,港北区,綱島西四丁目,85,12,3,9
2016/9/30,141097,港北区,綱島西四丁目,86,4,1,3
2016/9/30,141097,港北区,綱島西四丁目,87,6,3,3
2016/9/30,141097,港北区,綱島西四丁目,88,7,2,5
2016/9/30,141097,港北区,綱島西四丁目,89,3,2,1
2016/9/30,141097,港北区,綱島西四丁目,90,3,2,1
2016/9/30,141097,港北区,綱島西四丁目,91,7,3,4
2016/9/30,141097,港北区,綱島西四丁目,92,5,1,4
2016/9/30,141097,港北区,綱島西四丁目,93,1,0,1
2016/9/30,141097,港北区,綱島西四丁目,94,2,1,1
2016/9/30,141097,港北区,綱島西四丁目,95,0,0,0
2016/9/30,141097,港北区,綱島西四丁目,96,1,0,1
2016/9/30,141097,港北区,綱島西四丁目,97,1,0,1
2016/9/30,141097,港北区,綱島西四丁目,98,0,0,0
2016/9/30,141097,港北区,綱島西四丁目,99,0,0,0
2016/9/30,141097,港北区,綱島西四丁目,100,0,0,0
2016/9/30,141097,港北区,綱島西五丁目,合計,5648,2808,2840
2016/9/30,141097,港北区,綱島西五丁目,0,66,40,26
2016/9/30,141097,港北区,綱島西五丁目,1,62,26,36
2016/9/30,141097,港北区,綱島西五丁目,2,70,34,36
2016/9/30,141097,港北区,綱島西五丁目,3,55,31,24
2016/9/30,141097,港北区,綱島西五丁目,4,58,32,26
2016/9/30,141097,港北区,綱島西五丁目,5,61,28,33
2016/9/30,141097,港北区,綱島西五丁目,6,67,32,35
2016/9/30,141097,港北区,綱島西五丁目,7,57,27,30
2016/9/30,141097,港北区,綱島西五丁目,8,49,28,21
2016/9/30,141097,港北区,綱島西五丁目,9,68,35,33
2016/9/30,141097,港北区,綱島西五丁目,10,75,33,42
2016/9/30,141097,港北区,綱島西五丁目,11,52,23,29
2016/9/30,141097,港北区,綱島西五丁目,12,80,44,36
2016/9/30,141097,港北区,綱島西五丁目,13,76,37,39
2016/9/30,141097,港北区,綱島西五丁目,14,68,42,26
2016/9/30,141097,港北区,綱島西五丁目,15,54,26,28
2016/9/30,141097,港北区,綱島西五丁目,16,62,30,32
2016/9/30,141097,港北区,綱島西五丁目,17,56,27,29
2016/9/30,141097,港北区,綱島西五丁目,18,45,27,18
2016/9/30,141097,港北区,綱島西五丁目,19,40,23,17
2016/9/30,141097,港北区,綱島西五丁目,20,39,12,27
2016/9/30,141097,港北区,綱島西五丁目,21,66,35,31
2016/9/30,141097,港北区,綱島西五丁目,22,47,26,21
2016/9/30,141097,港北区,綱島西五丁目,23,48,26,22
2016/9/30,141097,港北区,綱島西五丁目,24,47,29,18
2016/9/30,141097,港北区,綱島西五丁目,25,51,21,30
2016/9/30,141097,港北区,綱島西五丁目,26,49,26,23
2016/9/30,141097,港北区,綱島西五丁目,27,62,28,34
2016/9/30,141097,港北区,綱島西五丁目,28,67,31,36
2016/9/30,141097,港北区,綱島西五丁目,29,86,44,42
2016/9/30,141097,港北区,綱島西五丁目,30,70,35,35
2016/9/30,141097,港北区,綱島西五丁目,31,87,39,48
2016/9/30,141097,港北区,綱島西五丁目,32,85,46,39
2016/9/30,141097,港北区,綱島西五丁目,33,82,43,39
2016/9/30,141097,港北区,綱島西五丁目,34,97,50,47
2016/9/30,141097,港北区,綱島西五丁目,35,89,45,44
2016/9/30,141097,港北区,綱島西五丁目,36,90,45,45
2016/9/30,141097,港北区,綱島西五丁目,37,65,31,34
2016/9/30,141097,港北区,綱島西五丁目,38,91,47,44
2016/9/30,141097,港北区,綱島西五丁目,39,93,44,49
2016/9/30,141097,港北区,綱島西五丁目,40,109,45,64
2016/9/30,141097,港北区,綱島西五丁目,41,110,62,48
2016/9/30,141097,港北区,綱島西五丁目,42,132,62,70
2016/9/30,141097,港北区,綱島西五丁目,43,128,66,62
2016/9/30,141097,港北区,綱島西五丁目,44,108,57,51
2016/9/30,141097,港北区,綱島西五丁目,45,116,58,58
2016/9/30,141097,港北区,綱島西五丁目,46,112,61,51
2016/9/30,141097,港北区,綱島西五丁目,47,115,70,45
2016/9/30,141097,港北区,綱島西五丁目,48,106,61,45
2016/9/30,141097,港北区,綱島西五丁目,49,104,44,60
2016/9/30,141097,港北区,綱島西五丁目,50,75,40,35
2016/9/30,141097,港北区,綱島西五丁目,51,92,54,38
2016/9/30,141097,港北区,綱島西五丁目,52,79,40,39
2016/9/30,141097,港北区,綱島西五丁目,53,81,39,42
2016/9/30,141097,港北区,綱島西五丁目,54,68,30,38
2016/9/30,141097,港北区,綱島西五丁目,55,58,28,30
2016/9/30,141097,港北区,綱島西五丁目,56,60,35,25
2016/9/30,141097,港北区,綱島西五丁目,57,55,32,23
2016/9/30,141097,港北区,綱島西五丁目,58,55,28,27
2016/9/30,141097,港北区,綱島西五丁目,59,48,28,20
2016/9/30,141097,港北区,綱島西五丁目,60,39,24,15
2016/9/30,141097,港北区,綱島西五丁目,61,47,24,23
2016/9/30,141097,港北区,綱島西五丁目,62,31,13,18
2016/9/30,141097,港北区,綱島西五丁目,63,46,26,20
2016/9/30,141097,港北区,綱島西五丁目,64,49,27,22
2016/9/30,141097,港北区,綱島西五丁目,65,40,16,24
2016/9/30,141097,港北区,綱島西五丁目,66,55,26,29
2016/9/30,141097,港北区,綱島西五丁目,67,52,22,30
2016/9/30,141097,港北区,綱島西五丁目,68,72,37,35
2016/9/30,141097,港北区,綱島西五丁目,69,51,23,28
2016/9/30,141097,港北区,綱島西五丁目,70,38,16,22
2016/9/30,141097,港北区,綱島西五丁目,71,48,23,25
2016/9/30,141097,港北区,綱島西五丁目,72,46,16,30
2016/9/30,141097,港北区,綱島西五丁目,73,65,29,36
2016/9/30,141097,港北区,綱島西五丁目,74,52,24,28
2016/9/30,141097,港北区,綱島西五丁目,75,47,24,23
2016/9/30,141097,港北区,綱島西五丁目,76,45,17,28
2016/9/30,141097,港北区,綱島西五丁目,77,32,14,18
2016/9/30,141097,港北区,綱島西五丁目,78,40,18,22
2016/9/30,141097,港北区,綱島西五丁目,79,43,15,28
2016/9/30,141097,港北区,綱島西五丁目,80,27,12,15
2016/9/30,141097,港北区,綱島西五丁目,81,26,12,14
2016/9/30,141097,港北区,綱島西五丁目,82,28,12,16
2016/9/30,141097,港北区,綱島西五丁目,83,31,14,17
2016/9/30,141097,港北区,綱島西五丁目,84,17,6,11
2016/9/30,141097,港北区,綱島西五丁目,85,27,7,20
2016/9/30,141097,港北区,綱島西五丁目,86,30,14,16
2016/9/30,141097,港北区,綱島西五丁目,87,18,8,10
2016/9/30,141097,港北区,綱島西五丁目,88,16,4,12
2016/9/30,141097,港北区,綱島西五丁目,89,13,5,8
2016/9/30,141097,港北区,綱島西五丁目,90,11,4,7
2016/9/30,141097,港北区,綱島西五丁目,91,11,6,5
2016/9/30,141097,港北区,綱島西五丁目,92,1,0,1
2016/9/30,141097,港北区,綱島西五丁目,93,1,0,1
2016/9/30,141097,港北区,綱島西五丁目,94,3,2,1
2016/9/30,141097,港北区,綱島西五丁目,95,2,0,2
2016/9/30,141097,港北区,綱島西五丁目,96,2,0,2
2016/9/30,141097,港北区,綱島西五丁目,97,1,0,1
2016/9/30,141097,港北区,綱島西五丁目,98,2,0,2
2016/9/30,141097,港北区,綱島西五丁目,99,0,0,0
2016/9/30,141097,港北区,綱島西五丁目,100,0,0,0
2016/9/30,141097,港北区,綱島西六丁目,合計,3082,1556,1526
2016/9/30,141097,港北区,綱島西六丁目,0,45,29,16
2016/9/30,141097,港北区,綱島西六丁目,1,28,13,15
2016/9/30,141097,港北区,綱島西六丁目,2,32,18,14
2016/9/30,141097,港北区,綱島西六丁目,3,28,18,10
2016/9/30,141097,港北区,綱島西六丁目,4,25,15,10
2016/9/30,141097,港北区,綱島西六丁目,5,21,11,10
2016/9/30,141097,港北区,綱島西六丁目,6,35,13,22
2016/9/30,141097,港北区,綱島西六丁目,7,20,6,14
2016/9/30,141097,港北区,綱島西六丁目,8,35,15,20
2016/9/30,141097,港北区,綱島西六丁目,9,21,14,7
2016/9/30,141097,港北区,綱島西六丁目,10,25,11,14
2016/9/30,141097,港北区,綱島西六丁目,11,23,15,8
2016/9/30,141097,港北区,綱島西六丁目,12,21,9,12
2016/9/30,141097,港北区,綱島西六丁目,13,30,11,19
2016/9/30,141097,港北区,綱島西六丁目,14,23,14,9
2016/9/30,141097,港北区,綱島西六丁目,15,22,11,11
2016/9/30,141097,港北区,綱島西六丁目,16,27,15,12
2016/9/30,141097,港北区,綱島西六丁目,17,25,10,15
2016/9/30,141097,港北区,綱島西六丁目,18,22,9,13
2016/9/30,141097,港北区,綱島西六丁目,19,25,11,14
2016/9/30,141097,港北区,綱島西六丁目,20,37,25,12
2016/9/30,141097,港北区,綱島西六丁目,21,32,12,20
2016/9/30,141097,港北区,綱島西六丁目,22,34,20,14
2016/9/30,141097,港北区,綱島西六丁目,23,44,22,22
2016/9/30,141097,港北区,綱島西六丁目,24,40,22,18
2016/9/30,141097,港北区,綱島西六丁目,25,41,13,28
2016/9/30,141097,港北区,綱島西六丁目,26,44,20,24
2016/9/30,141097,港北区,綱島西六丁目,27,55,25,30
2016/9/30,141097,港北区,綱島西六丁目,28,46,23,23
2016/9/30,141097,港北区,綱島西六丁目,29,59,29,30
2016/9/30,141097,港北区,綱島西六丁目,30,62,33,29
2016/9/30,141097,港北区,綱島西六丁目,31,56,23,33
2016/9/30,141097,港北区,綱島西六丁目,32,50,20,30
2016/9/30,141097,港北区,綱島西六丁目,33,59,27,32
2016/9/30,141097,港北区,綱島西六丁目,34,43,28,15
2016/9/30,141097,港北区,綱島西六丁目,35,62,31,31
2016/9/30,141097,港北区,綱島西六丁目,36,63,32,31
2016/9/30,141097,港北区,綱島西六丁目,37,60,32,28
2016/9/30,141097,港北区,綱島西六丁目,38,54,31,23
2016/9/30,141097,港北区,綱島西六丁目,39,55,26,29
2016/9/30,141097,港北区,綱島西六丁目,40,54,24,30
2016/9/30,141097,港北区,綱島西六丁目,41,48,29,19
2016/9/30,141097,港北区,綱島西六丁目,42,53,24,29
2016/9/30,141097,港北区,綱島西六丁目,43,68,35,33
2016/9/30,141097,港北区,綱島西六丁目,44,51,23,28
2016/9/30,141097,港北区,綱島西六丁目,45,61,31,30
2016/9/30,141097,港北区,綱島西六丁目,46,58,32,26
2016/9/30,141097,港北区,綱島西六丁目,47,32,20,12
2016/9/30,141097,港北区,綱島西六丁目,48,50,26,24
2016/9/30,141097,港北区,綱島西六丁目,49,41,15,26
2016/9/30,141097,港北区,綱島西六丁目,50,31,16,15
2016/9/30,141097,港北区,綱島西六丁目,51,65,32,33
2016/9/30,141097,港北区,綱島西六丁目,52,39,19,20
2016/9/30,141097,港北区,綱島西六丁目,53,51,26,25
2016/9/30,141097,港北区,綱島西六丁目,54,36,22,14
2016/9/30,141097,港北区,綱島西六丁目,55,43,25,18
2016/9/30,141097,港北区,綱島西六丁目,56,35,21,14
2016/9/30,141097,港北区,綱島西六丁目,57,36,26,10
2016/9/30,141097,港北区,綱島西六丁目,58,36,16,20
2016/9/30,141097,港北区,綱島西六丁目,59,34,15,19
2016/9/30,141097,港北区,綱島西六丁目,60,15,6,9
2016/9/30,141097,港北区,綱島西六丁目,61,31,18,13
2016/9/30,141097,港北区,綱島西六丁目,62,24,15,9
2016/9/30,141097,港北区,綱島西六丁目,63,18,10,8
2016/9/30,141097,港北区,綱島西六丁目,64,16,5,11
2016/9/30,141097,港北区,綱島西六丁目,65,33,20,13
2016/9/30,141097,港北区,綱島西六丁目,66,30,21,9
2016/9/30,141097,港北区,綱島西六丁目,67,27,14,13
2016/9/30,141097,港北区,綱島西六丁目,68,45,29,16
2016/9/30,141097,港北区,綱島西六丁目,69,37,20,17
2016/9/30,141097,港北区,綱島西六丁目,70,24,9,15
2016/9/30,141097,港北区,綱島西六丁目,71,19,7,12
2016/9/30,141097,港北区,綱島西六丁目,72,22,8,14
2016/9/30,141097,港北区,綱島西六丁目,73,18,7,11
2016/9/30,141097,港北区,綱島西六丁目,74,23,11,12
2016/9/30,141097,港北区,綱島西六丁目,75,30,18,12
2016/9/30,141097,港北区,綱島西六丁目,76,13,5,8
2016/9/30,141097,港北区,綱島西六丁目,77,25,13,12
2016/9/30,141097,港北区,綱島西六丁目,78,15,6,9
2016/9/30,141097,港北区,綱島西六丁目,79,21,11,10
2016/9/30,141097,港北区,綱島西六丁目,80,14,6,8
2016/9/30,141097,港北区,綱島西六丁目,81,19,5,14
2016/9/30,141097,港北区,綱島西六丁目,82,14,9,5
2016/9/30,141097,港北区,綱島西六丁目,83,17,8,9
2016/9/30,141097,港北区,綱島西六丁目,84,16,8,8
2016/9/30,141097,港北区,綱島西六丁目,85,9,3,6
2016/9/30,141097,港北区,綱島西六丁目,86,7,4,3
2016/9/30,141097,港北区,綱島西六丁目,87,12,2,10
2016/9/30,141097,港北区,綱島西六丁目,88,11,6,5
2016/9/30,141097,港北区,綱島西六丁目,89,5,3,2
2016/9/30,141097,港北区,綱島西六丁目,90,4,4,0
2016/9/30,141097,港北区,綱島西六丁目,91,6,2,4
2016/9/30,141097,港北区,綱島西六丁目,92,0,0,0
2016/9/30,141097,港北区,綱島西六丁目,93,2,1,1
2016/9/30,141097,港北区,綱島西六丁目,94,0,0,0
2016/9/30,141097,港北区,綱島西六丁目,95,4,2,2
2016/9/30,141097,港北区,綱島西六丁目,96,1,0,1
2016/9/30,141097,港北区,綱島西六丁目,97,1,0,1
2016/9/30,141097,港北区,綱島西六丁目,98,2,1,1
2016/9/30,141097,港北区,綱島西六丁目,99,1,0,1
2016/9/30,141097,港北区,綱島西六丁目,100,0,0,0
2016/9/30,141097,港北区,箕輪町一丁目,合計,1807,908,899
2016/9/30,141097,港北区,箕輪町一丁目,0,21,10,11
2016/9/30,141097,港北区,箕輪町一丁目,1,13,8,5
2016/9/30,141097,港北区,箕輪町一丁目,2,16,9,7
2016/9/30,141097,港北区,箕輪町一丁目,3,15,5,10
2016/9/30,141097,港北区,箕輪町一丁目,4,6,3,3
2016/9/30,141097,港北区,箕輪町一丁目,5,15,9,6
2016/9/30,141097,港北区,箕輪町一丁目,6,14,10,4
2016/9/30,141097,港北区,箕輪町一丁目,7,12,4,8
2016/9/30,141097,港北区,箕輪町一丁目,8,13,9,4
2016/9/30,141097,港北区,箕輪町一丁目,9,10,6,4
2016/9/30,141097,港北区,箕輪町一丁目,10,4,1,3
2016/9/30,141097,港北区,箕輪町一丁目,11,13,4,9
2016/9/30,141097,港北区,箕輪町一丁目,12,17,9,8
2016/9/30,141097,港北区,箕輪町一丁目,13,13,10,3
2016/9/30,141097,港北区,箕輪町一丁目,14,9,7,2
2016/9/30,141097,港北区,箕輪町一丁目,15,6,2,4
2016/9/30,141097,港北区,箕輪町一丁目,16,12,5,7
2016/9/30,141097,港北区,箕輪町一丁目,17,10,3,7
2016/9/30,141097,港北区,箕輪町一丁目,18,11,6,5
2016/9/30,141097,港北区,箕輪町一丁目,19,15,9,6
2016/9/30,141097,港北区,箕輪町一丁目,20,23,15,8
2016/9/30,141097,港北区,箕輪町一丁目,21,21,12,9
2016/9/30,141097,港北区,箕輪町一丁目,22,31,18,13
2016/9/30,141097,港北区,箕輪町一丁目,23,22,12,10
2016/9/30,141097,港北区,箕輪町一丁目,24,33,13,20
2016/9/30,141097,港北区,箕輪町一丁目,25,33,22,11
2016/9/30,141097,港北区,箕輪町一丁目,26,27,19,8
2016/9/30,141097,港北区,箕輪町一丁目,27,24,13,11
2016/9/30,141097,港北区,箕輪町一丁目,28,36,18,18
2016/9/30,141097,港北区,箕輪町一丁目,29,42,27,15
2016/9/30,141097,港北区,箕輪町一丁目,30,30,14,16
2016/9/30,141097,港北区,箕輪町一丁目,31,34,18,16
2016/9/30,141097,港北区,箕輪町一丁目,32,40,23,17
2016/9/30,141097,港北区,箕輪町一丁目,33,34,20,14
2016/9/30,141097,港北区,箕輪町一丁目,34,25,13,12
2016/9/30,141097,港北区,箕輪町一丁目,35,28,14,14
2016/9/30,141097,港北区,箕輪町一丁目,36,18,7,11
2016/9/30,141097,港北区,箕輪町一丁目,37,28,17,11
2016/9/30,141097,港北区,箕輪町一丁目,38,27,13,14
2016/9/30,141097,港北区,箕輪町一丁目,39,24,13,11
2016/9/30,141097,港北区,箕輪町一丁目,40,31,16,15
2016/9/30,141097,港北区,箕輪町一丁目,41,27,13,14
2016/9/30,141097,港北区,箕輪町一丁目,42,38,19,19
2016/9/30,141097,港北区,箕輪町一丁目,43,29,10,19
2016/9/30,141097,港北区,箕輪町一丁目,44,39,22,17
2016/9/30,141097,港北区,箕輪町一丁目,45,20,6,14
2016/9/30,141097,港北区,箕輪町一丁目,46,22,15,7
2016/9/30,141097,港北区,箕輪町一丁目,47,28,13,15
2016/9/30,141097,港北区,箕輪町一丁目,48,29,17,12
2016/9/30,141097,港北区,箕輪町一丁目,49,27,10,17
2016/9/30,141097,港北区,箕輪町一丁目,50,20,10,10
2016/9/30,141097,港北区,箕輪町一丁目,51,15,9,6
2016/9/30,141097,港北区,箕輪町一丁目,52,35,15,20
2016/9/30,141097,港北区,箕輪町一丁目,53,22,10,12
2016/9/30,141097,港北区,箕輪町一丁目,54,22,9,13
2016/9/30,141097,港北区,箕輪町一丁目,55,28,14,14
2016/9/30,141097,港北区,箕輪町一丁目,56,27,12,15
2016/9/30,141097,港北区,箕輪町一丁目,57,25,15,10
2016/9/30,141097,港北区,箕輪町一丁目,58,35,20,15
2016/9/30,141097,港北区,箕輪町一丁目,59,20,9,11
2016/9/30,141097,港北区,箕輪町一丁目,60,15,6,9
2016/9/30,141097,港北区,箕輪町一丁目,61,21,9,12
2016/9/30,141097,港北区,箕輪町一丁目,62,18,10,8
2016/9/30,141097,港北区,箕輪町一丁目,63,16,4,12
2016/9/30,141097,港北区,箕輪町一丁目,64,23,12,11
2016/9/30,141097,港北区,箕輪町一丁目,65,25,12,13
2016/9/30,141097,港北区,箕輪町一丁目,66,21,10,11
2016/9/30,141097,港北区,箕輪町一丁目,67,28,12,16
2016/9/30,141097,港北区,箕輪町一丁目,68,27,14,13
2016/9/30,141097,港北区,箕輪町一丁目,69,17,9,8
2016/9/30,141097,港北区,箕輪町一丁目,70,15,6,9
2016/9/30,141097,港北区,箕輪町一丁目,71,14,8,6
2016/9/30,141097,港北区,箕輪町一丁目,72,20,7,13
2016/9/30,141097,港北区,箕輪町一丁目,73,11,5,6
2016/9/30,141097,港北区,箕輪町一丁目,74,16,6,10
2016/9/30,141097,港北区,箕輪町一丁目,75,10,7,3
2016/9/30,141097,港北区,箕輪町一丁目,76,10,4,6
2016/9/30,141097,港北区,箕輪町一丁目,77,15,5,10
2016/9/30,141097,港北区,箕輪町一丁目,78,18,5,13
2016/9/30,141097,港北区,箕輪町一丁目,79,13,10,3
2016/9/30,141097,港北区,箕輪町一丁目,80,11,6,5
2016/9/30,141097,港北区,箕輪町一丁目,81,9,4,5
2016/9/30,141097,港北区,箕輪町一丁目,82,7,2,5
2016/9/30,141097,港北区,箕輪町一丁目,83,6,5,1
2016/9/30,141097,港北区,箕輪町一丁目,84,3,1,2
2016/9/30,141097,港北区,箕輪町一丁目,85,8,4,4
2016/9/30,141097,港北区,箕輪町一丁目,86,8,1,7
2016/9/30,141097,港北区,箕輪町一丁目,87,7,4,3
2016/9/30,141097,港北区,箕輪町一丁目,88,4,0,4
2016/9/30,141097,港北区,箕輪町一丁目,89,3,0,3
2016/9/30,141097,港北区,箕輪町一丁目,90,7,2,5
2016/9/30,141097,港北区,箕輪町一丁目,91,4,1,3
2016/9/30,141097,港北区,箕輪町一丁目,92,4,0,4
2016/9/30,141097,港北区,箕輪町一丁目,93,3,1,2
2016/9/30,141097,港北区,箕輪町一丁目,94,0,0,0
2016/9/30,141097,港北区,箕輪町一丁目,95,4,1,3
2016/9/30,141097,港北区,箕輪町一丁目,96,0,0,0
2016/9/30,141097,港北区,箕輪町一丁目,97,0,0,0
2016/9/30,141097,港北区,箕輪町一丁目,98,0,0,0
2016/9/30,141097,港北区,箕輪町一丁目,99,0,0,0
2016/9/30,141097,港北区,箕輪町一丁目,100,2,1,1
2016/9/30,141097,港北区,箕輪町二丁目,合計,5031,2434,2597
2016/9/30,141097,港北区,箕輪町二丁目,0,44,17,27
2016/9/30,141097,港北区,箕輪町二丁目,1,49,26,23
2016/9/30,141097,港北区,箕輪町二丁目,2,48,23,25
2016/9/30,141097,港北区,箕輪町二丁目,3,54,16,38
2016/9/30,141097,港北区,箕輪町二丁目,4,47,23,24
2016/9/30,141097,港北区,箕輪町二丁目,5,40,22,18
2016/9/30,141097,港北区,箕輪町二丁目,6,34,22,12
2016/9/30,141097,港北区,箕輪町二丁目,7,34,17,17
2016/9/30,141097,港北区,箕輪町二丁目,8,31,14,17
2016/9/30,141097,港北区,箕輪町二丁目,9,38,17,21
2016/9/30,141097,港北区,箕輪町二丁目,10,33,21,12
2016/9/30,141097,港北区,箕輪町二丁目,11,39,16,23
2016/9/30,141097,港北区,箕輪町二丁目,12,33,20,13
2016/9/30,141097,港北区,箕輪町二丁目,13,32,12,20
2016/9/30,141097,港北区,箕輪町二丁目,14,32,15,17
2016/9/30,141097,港北区,箕輪町二丁目,15,41,16,25
2016/9/30,141097,港北区,箕輪町二丁目,16,46,19,27
2016/9/30,141097,港北区,箕輪町二丁目,17,43,22,21
2016/9/30,141097,港北区,箕輪町二丁目,18,46,27,19
2016/9/30,141097,港北区,箕輪町二丁目,19,47,21,26
2016/9/30,141097,港北区,箕輪町二丁目,20,47,27,20
2016/9/30,141097,港北区,箕輪町二丁目,21,60,33,27
2016/9/30,141097,港北区,箕輪町二丁目,22,62,33,29
2016/9/30,141097,港北区,箕輪町二丁目,23,54,22,32
2016/9/30,141097,港北区,箕輪町二丁目,24,63,25,38
2016/9/30,141097,港北区,箕輪町二丁目,25,67,33,34
2016/9/30,141097,港北区,箕輪町二丁目,26,62,38,24
2016/9/30,141097,港北区,箕輪町二丁目,27,80,40,40
2016/9/30,141097,港北区,箕輪町二丁目,28,81,45,36
2016/9/30,141097,港北区,箕輪町二丁目,29,77,39,38
2016/9/30,141097,港北区,箕輪町二丁目,30,78,34,44
2016/9/30,141097,港北区,箕輪町二丁目,31,68,31,37
2016/9/30,141097,港北区,箕輪町二丁目,32,73,32,41
2016/9/30,141097,港北区,箕輪町二丁目,33,84,43,41
2016/9/30,141097,港北区,箕輪町二丁目,34,48,24,24
2016/9/30,141097,港北区,箕輪町二丁目,35,68,33,35
2016/9/30,141097,港北区,箕輪町二丁目,36,75,39,36
2016/9/30,141097,港北区,箕輪町二丁目,37,83,43,40
2016/9/30,141097,港北区,箕輪町二丁目,38,86,40,46
2016/9/30,141097,港北区,箕輪町二丁目,39,82,41,41
2016/9/30,141097,港北区,箕輪町二丁目,40,67,32,35
2016/9/30,141097,港北区,箕輪町二丁目,41,75,39,36
2016/9/30,141097,港北区,箕輪町二丁目,42,74,37,37
2016/9/30,141097,港北区,箕輪町二丁目,43,81,40,41
2016/9/30,141097,港北区,箕輪町二丁目,44,88,48,40
2016/9/30,141097,港北区,箕輪町二丁目,45,80,34,46
2016/9/30,141097,港北区,箕輪町二丁目,46,70,28,42
2016/9/30,141097,港北区,箕輪町二丁目,47,101,52,49
2016/9/30,141097,港北区,箕輪町二丁目,48,92,47,45
2016/9/30,141097,港北区,箕輪町二丁目,49,82,33,49
2016/9/30,141097,港北区,箕輪町二丁目,50,76,44,32
2016/9/30,141097,港北区,箕輪町二丁目,51,109,60,49
2016/9/30,141097,港北区,箕輪町二丁目,52,81,33,48
2016/9/30,141097,港北区,箕輪町二丁目,53,60,27,33
2016/9/30,141097,港北区,箕輪町二丁目,54,68,35,33
2016/9/30,141097,港北区,箕輪町二丁目,55,89,37,52
2016/9/30,141097,港北区,箕輪町二丁目,56,67,34,33
2016/9/30,141097,港北区,箕輪町二丁目,57,68,37,31
2016/9/30,141097,港北区,箕輪町二丁目,58,84,37,47
2016/9/30,141097,港北区,箕輪町二丁目,59,59,25,34
2016/9/30,141097,港北区,箕輪町二丁目,60,78,33,45
2016/9/30,141097,港北区,箕輪町二丁目,61,70,39,31
2016/9/30,141097,港北区,箕輪町二丁目,62,66,37,29
2016/9/30,141097,港北区,箕輪町二丁目,63,73,33,40
2016/9/30,141097,港北区,箕輪町二丁目,64,64,27,37
2016/9/30,141097,港北区,箕輪町二丁目,65,79,39,40
2016/9/30,141097,港北区,箕輪町二丁目,66,72,36,36
2016/9/30,141097,港北区,箕輪町二丁目,67,82,43,39
2016/9/30,141097,港北区,箕輪町二丁目,68,77,45,32
2016/9/30,141097,港北区,箕輪町二丁目,69,55,27,28
2016/9/30,141097,港北区,箕輪町二丁目,70,35,21,14
2016/9/30,141097,港北区,箕輪町二丁目,71,43,17,26
2016/9/30,141097,港北区,箕輪町二丁目,72,48,25,23
2016/9/30,141097,港北区,箕輪町二丁目,73,36,14,22
2016/9/30,141097,港北区,箕輪町二丁目,74,43,18,25
2016/9/30,141097,港北区,箕輪町二丁目,75,46,24,22
2016/9/30,141097,港北区,箕輪町二丁目,76,40,20,20
2016/9/30,141097,港北区,箕輪町二丁目,77,36,10,26
2016/9/30,141097,港北区,箕輪町二丁目,78,24,10,14
2016/9/30,141097,港北区,箕輪町二丁目,79,18,8,10
2016/9/30,141097,港北区,箕輪町二丁目,80,26,13,13
2016/9/30,141097,港北区,箕輪町二丁目,81,16,5,11
2016/9/30,141097,港北区,箕輪町二丁目,82,12,3,9
2016/9/30,141097,港北区,箕輪町二丁目,83,15,5,10
2016/9/30,141097,港北区,箕輪町二丁目,84,25,13,12
2016/9/30,141097,港北区,箕輪町二丁目,85,15,8,7
2016/9/30,141097,港北区,箕輪町二丁目,86,11,5,6
2016/9/30,141097,港北区,箕輪町二丁目,87,12,4,8
2016/9/30,141097,港北区,箕輪町二丁目,88,9,5,4
2016/9/30,141097,港北区,箕輪町二丁目,89,6,3,3
2016/9/30,141097,港北区,箕輪町二丁目,90,5,1,4
2016/9/30,141097,港北区,箕輪町二丁目,91,6,1,5
2016/9/30,141097,港北区,箕輪町二丁目,92,2,0,2
2016/9/30,141097,港北区,箕輪町二丁目,93,1,1,0
2016/9/30,141097,港北区,箕輪町二丁目,94,0,0,0
2016/9/30,141097,港北区,箕輪町二丁目,95,2,0,2
2016/9/30,141097,港北区,箕輪町二丁目,96,1,1,0
2016/9/30,141097,港北区,箕輪町二丁目,97,0,0,0
2016/9/30,141097,港北区,箕輪町二丁目,98,1,0,1
2016/9/30,141097,港北区,箕輪町二丁目,99,0,0,0
2016/9/30,141097,港北区,箕輪町二丁目,100,1,0,1
2016/9/30,141097,港北区,箕輪町三丁目,合計,2627,1351,1276
2016/9/30,141097,港北区,箕輪町三丁目,0,35,16,19
2016/9/30,141097,港北区,箕輪町三丁目,1,46,21,25
2016/9/30,141097,港北区,箕輪町三丁目,2,36,18,18
2016/9/30,141097,港北区,箕輪町三丁目,3,31,15,16
2016/9/30,141097,港北区,箕輪町三丁目,4,23,14,9
2016/9/30,141097,港北区,箕輪町三丁目,5,19,7,12
2016/9/30,141097,港北区,箕輪町三丁目,6,27,14,13
2016/9/30,141097,港北区,箕輪町三丁目,7,12,4,8
2016/9/30,141097,港北区,箕輪町三丁目,8,26,12,14
2016/9/30,141097,港北区,箕輪町三丁目,9,25,13,12
2016/9/30,141097,港北区,箕輪町三丁目,10,11,6,5
2016/9/30,141097,港北区,箕輪町三丁目,11,19,7,12
2016/9/30,141097,港北区,箕輪町三丁目,12,16,8,8
2016/9/30,141097,港北区,箕輪町三丁目,13,13,7,6
2016/9/30,141097,港北区,箕輪町三丁目,14,16,10,6
2016/9/30,141097,港北区,箕輪町三丁目,15,16,11,5
2016/9/30,141097,港北区,箕輪町三丁目,16,23,14,9
2016/9/30,141097,港北区,箕輪町三丁目,17,15,8,7
2016/9/30,141097,港北区,箕輪町三丁目,18,25,9,16
2016/9/30,141097,港北区,箕輪町三丁目,19,20,11,9
2016/9/30,141097,港北区,箕輪町三丁目,20,22,13,9
2016/9/30,141097,港北区,箕輪町三丁目,21,26,11,15
2016/9/30,141097,港北区,箕輪町三丁目,22,26,16,10
2016/9/30,141097,港北区,箕輪町三丁目,23,36,22,14
2016/9/30,141097,港北区,箕輪町三丁目,24,31,11,20
2016/9/30,141097,港北区,箕輪町三丁目,25,38,13,25
2016/9/30,141097,港北区,箕輪町三丁目,26,45,21,24
2016/9/30,141097,港北区,箕輪町三丁目,27,52,28,24
2016/9/30,141097,港北区,箕輪町三丁目,28,67,37,30
2016/9/30,141097,港北区,箕輪町三丁目,29,51,27,24
2016/9/30,141097,港北区,箕輪町三丁目,30,73,32,41
2016/9/30,141097,港北区,箕輪町三丁目,31,61,32,29
2016/9/30,141097,港北区,箕輪町三丁目,32,66,40,26
2016/9/30,141097,港北区,箕輪町三丁目,33,62,36,26
2016/9/30,141097,港北区,箕輪町三丁目,34,60,35,25
2016/9/30,141097,港北区,箕輪町三丁目,35,50,33,17
2016/9/30,141097,港北区,箕輪町三丁目,36,59,30,29
2016/9/30,141097,港北区,箕輪町三丁目,37,56,29,27
2016/9/30,141097,港北区,箕輪町三丁目,38,65,33,32
2016/9/30,141097,港北区,箕輪町三丁目,39,48,25,23
2016/9/30,141097,港北区,箕輪町三丁目,40,51,24,27
2016/9/30,141097,港北区,箕輪町三丁目,41,51,31,20
2016/9/30,141097,港北区,箕輪町三丁目,42,45,24,21
2016/9/30,141097,港北区,箕輪町三丁目,43,43,28,15
2016/9/30,141097,港北区,箕輪町三丁目,44,55,25,30
2016/9/30,141097,港北区,箕輪町三丁目,45,46,26,20
2016/9/30,141097,港北区,箕輪町三丁目,46,40,19,21
2016/9/30,141097,港北区,箕輪町三丁目,47,42,19,23
2016/9/30,141097,港北区,箕輪町三丁目,48,44,21,23
2016/9/30,141097,港北区,箕輪町三丁目,49,46,27,19
2016/9/30,141097,港北区,箕輪町三丁目,50,40,19,21
2016/9/30,141097,港北区,箕輪町三丁目,51,34,21,13
2016/9/30,141097,港北区,箕輪町三丁目,52,32,19,13
2016/9/30,141097,港北区,箕輪町三丁目,53,32,22,10
2016/9/30,141097,港北区,箕輪町三丁目,54,27,13,14
2016/9/30,141097,港北区,箕輪町三丁目,55,22,14,8
2016/9/30,141097,港北区,箕輪町三丁目,56,23,9,14
2016/9/30,141097,港北区,箕輪町三丁目,57,18,13,5
2016/9/30,141097,港北区,箕輪町三丁目,58,22,13,9
2016/9/30,141097,港北区,箕輪町三丁目,59,13,4,9
2016/9/30,141097,港北区,箕輪町三丁目,60,18,12,6
2016/9/30,141097,港北区,箕輪町三丁目,61,20,11,9
2016/9/30,141097,港北区,箕輪町三丁目,62,15,9,6
2016/9/30,141097,港北区,箕輪町三丁目,63,21,11,10
2016/9/30,141097,港北区,箕輪町三丁目,64,20,10,10
2016/9/30,141097,港北区,箕輪町三丁目,65,22,11,11
2016/9/30,141097,港北区,箕輪町三丁目,66,16,7,9
2016/9/30,141097,港北区,箕輪町三丁目,67,14,9,5
2016/9/30,141097,港北区,箕輪町三丁目,68,24,10,14
2016/9/30,141097,港北区,箕輪町三丁目,69,22,15,7
2016/9/30,141097,港北区,箕輪町三丁目,70,7,4,3
2016/9/30,141097,港北区,箕輪町三丁目,71,12,4,8
2016/9/30,141097,港北区,箕輪町三丁目,72,18,8,10
2016/9/30,141097,港北区,箕輪町三丁目,73,19,4,15
2016/9/30,141097,港北区,箕輪町三丁目,74,23,11,12
2016/9/30,141097,港北区,箕輪町三丁目,75,16,6,10
2016/9/30,141097,港北区,箕輪町三丁目,76,17,8,9
2016/9/30,141097,港北区,箕輪町三丁目,77,19,10,9
2016/9/30,141097,港北区,箕輪町三丁目,78,10,7,3
2016/9/30,141097,港北区,箕輪町三丁目,79,8,3,5
2016/9/30,141097,港北区,箕輪町三丁目,80,14,6,8
2016/9/30,141097,港北区,箕輪町三丁目,81,12,4,8
2016/9/30,141097,港北区,箕輪町三丁目,82,12,3,9
2016/9/30,141097,港北区,箕輪町三丁目,83,10,4,6
2016/9/30,141097,港北区,箕輪町三丁目,84,9,5,4
2016/9/30,141097,港北区,箕輪町三丁目,85,7,3,4
2016/9/30,141097,港北区,箕輪町三丁目,86,8,4,4
2016/9/30,141097,港北区,箕輪町三丁目,87,4,1,3
2016/9/30,141097,港北区,箕輪町三丁目,88,3,0,3
2016/9/30,141097,港北区,箕輪町三丁目,89,6,0,6
2016/9/30,141097,港北区,箕輪町三丁目,90,5,3,2
2016/9/30,141097,港北区,箕輪町三丁目,91,6,3,3
2016/9/30,141097,港北区,箕輪町三丁目,92,3,1,2
2016/9/30,141097,港北区,箕輪町三丁目,93,4,1,3
2016/9/30,141097,港北区,箕輪町三丁目,94,2,2,0
2016/9/30,141097,港北区,箕輪町三丁目,95,2,0,2
2016/9/30,141097,港北区,箕輪町三丁目,96,4,0,4
2016/9/30,141097,港北区,箕輪町三丁目,97,1,1,0
2016/9/30,141097,港北区,箕輪町三丁目,98,0,0,0
2016/9/30,141097,港北区,箕輪町三丁目,99,0,0,0
2016/9/30,141097,港北区,箕輪町三丁目,100,0,0,0
2016/9/30,141097,港北区,日吉一丁目,合計,2234,1069,1165
2016/9/30,141097,港北区,日吉一丁目,0,21,7,14
2016/9/30,141097,港北区,日吉一丁目,1,13,7,6
2016/9/30,141097,港北区,日吉一丁目,2,11,3,8
2016/9/30,141097,港北区,日吉一丁目,3,17,6,11
2016/9/30,141097,港北区,日吉一丁目,4,18,8,10
2016/9/30,141097,港北区,日吉一丁目,5,13,7,6
2016/9/30,141097,港北区,日吉一丁目,6,13,10,3
2016/9/30,141097,港北区,日吉一丁目,7,13,8,5
2016/9/30,141097,港北区,日吉一丁目,8,18,13,5
2016/9/30,141097,港北区,日吉一丁目,9,12,5,7
2016/9/30,141097,港北区,日吉一丁目,10,11,4,7
2016/9/30,141097,港北区,日吉一丁目,11,6,2,4
2016/9/30,141097,港北区,日吉一丁目,12,19,11,8
2016/9/30,141097,港北区,日吉一丁目,13,15,10,5
2016/9/30,141097,港北区,日吉一丁目,14,14,8,6
2016/9/30,141097,港北区,日吉一丁目,15,18,12,6
2016/9/30,141097,港北区,日吉一丁目,16,25,11,14
2016/9/30,141097,港北区,日吉一丁目,17,16,7,9
2016/9/30,141097,港北区,日吉一丁目,18,21,13,8
2016/9/30,141097,港北区,日吉一丁目,19,21,8,13
2016/9/30,141097,港北区,日吉一丁目,20,32,23,9
2016/9/30,141097,港北区,日吉一丁目,21,21,11,10
2016/9/30,141097,港北区,日吉一丁目,22,29,13,16
2016/9/30,141097,港北区,日吉一丁目,23,30,15,15
2016/9/30,141097,港北区,日吉一丁目,24,37,19,18
2016/9/30,141097,港北区,日吉一丁目,25,37,19,18
2016/9/30,141097,港北区,日吉一丁目,26,35,14,21
2016/9/30,141097,港北区,日吉一丁目,27,32,16,16
2016/9/30,141097,港北区,日吉一丁目,28,39,16,23
2016/9/30,141097,港北区,日吉一丁目,29,32,14,18
2016/9/30,141097,港北区,日吉一丁目,30,35,23,12
2016/9/30,141097,港北区,日吉一丁目,31,37,19,18
2016/9/30,141097,港北区,日吉一丁目,32,36,20,16
2016/9/30,141097,港北区,日吉一丁目,33,26,15,11
2016/9/30,141097,港北区,日吉一丁目,34,30,17,13
2016/9/30,141097,港北区,日吉一丁目,35,31,18,13
2016/9/30,141097,港北区,日吉一丁目,36,29,9,20
2016/9/30,141097,港北区,日吉一丁目,37,26,12,14
2016/9/30,141097,港北区,日吉一丁目,38,18,8,10
2016/9/30,141097,港北区,日吉一丁目,39,30,14,16
2016/9/30,141097,港北区,日吉一丁目,40,39,20,19
2016/9/30,141097,港北区,日吉一丁目,41,33,17,16
2016/9/30,141097,港北区,日吉一丁目,42,29,14,15
2016/9/30,141097,港北区,日吉一丁目,43,32,17,15
2016/9/30,141097,港北区,日吉一丁目,44,45,24,21
2016/9/30,141097,港北区,日吉一丁目,45,34,13,21
2016/9/30,141097,港北区,日吉一丁目,46,35,20,15
2016/9/30,141097,港北区,日吉一丁目,47,32,19,13
2016/9/30,141097,港北区,日吉一丁目,48,26,13,13
2016/9/30,141097,港北区,日吉一丁目,49,39,18,21
2016/9/30,141097,港北区,日吉一丁目,50,31,18,13
2016/9/30,141097,港北区,日吉一丁目,51,32,17,15
2016/9/30,141097,港北区,日吉一丁目,52,22,9,13
2016/9/30,141097,港北区,日吉一丁目,53,32,12,20
2016/9/30,141097,港北区,日吉一丁目,54,29,10,19
2016/9/30,141097,港北区,日吉一丁目,55,22,11,11
2016/9/30,141097,港北区,日吉一丁目,56,25,12,13
2016/9/30,141097,港北区,日吉一丁目,57,32,15,17
2016/9/30,141097,港北区,日吉一丁目,58,34,18,16
2016/9/30,141097,港北区,日吉一丁目,59,16,10,6
2016/9/30,141097,港北区,日吉一丁目,60,29,14,15
2016/9/30,141097,港北区,日吉一丁目,61,30,19,11
2016/9/30,141097,港北区,日吉一丁目,62,22,9,13
2016/9/30,141097,港北区,日吉一丁目,63,23,8,15
2016/9/30,141097,港北区,日吉一丁目,64,30,14,16
2016/9/30,141097,港北区,日吉一丁目,65,23,10,13
2016/9/30,141097,港北区,日吉一丁目,66,28,14,14
2016/9/30,141097,港北区,日吉一丁目,67,32,17,15
2016/9/30,141097,港北区,日吉一丁目,68,25,10,15
2016/9/30,141097,港北区,日吉一丁目,69,29,16,13
2016/9/30,141097,港北区,日吉一丁目,70,27,11,16
2016/9/30,141097,港北区,日吉一丁目,71,20,6,14
2016/9/30,141097,港北区,日吉一丁目,72,25,11,14
2016/9/30,141097,港北区,日吉一丁目,73,26,10,16
2016/9/30,141097,港北区,日吉一丁目,74,30,16,14
2016/9/30,141097,港北区,日吉一丁目,75,16,9,7
2016/9/30,141097,港北区,日吉一丁目,76,23,13,10
2016/9/30,141097,港北区,日吉一丁目,77,21,7,14
2016/9/30,141097,港北区,日吉一丁目,78,17,8,9
2016/9/30,141097,港北区,日吉一丁目,79,14,4,10
2016/9/30,141097,港北区,日吉一丁目,80,15,7,8
2016/9/30,141097,港北区,日吉一丁目,81,21,8,13
2016/9/30,141097,港北区,日吉一丁目,82,20,8,12
2016/9/30,141097,港北区,日吉一丁目,83,14,8,6
2016/9/30,141097,港北区,日吉一丁目,84,13,7,6
2016/9/30,141097,港北区,日吉一丁目,85,10,1,9
2016/9/30,141097,港北区,日吉一丁目,86,14,2,12
2016/9/30,141097,港北区,日吉一丁目,87,12,1,11
2016/9/30,141097,港北区,日吉一丁目,88,10,2,8
2016/9/30,141097,港北区,日吉一丁目,89,13,5,8
2016/9/30,141097,港北区,日吉一丁目,90,10,2,8
2016/9/30,141097,港北区,日吉一丁目,91,11,2,9
2016/9/30,141097,港北区,日吉一丁目,92,5,2,3
2016/9/30,141097,港北区,日吉一丁目,93,7,3,4
2016/9/30,141097,港北区,日吉一丁目,94,8,2,6
2016/9/30,141097,港北区,日吉一丁目,95,2,1,1
2016/9/30,141097,港北区,日吉一丁目,96,1,0,1
2016/9/30,141097,港北区,日吉一丁目,97,0,0,0
2016/9/30,141097,港北区,日吉一丁目,98,1,0,1
2016/9/30,141097,港北区,日吉一丁目,99,0,0,0
2016/9/30,141097,港北区,日吉一丁目,100,1,0,1
2016/9/30,141097,港北区,日吉二丁目,合計,3035,1515,1520
2016/9/30,141097,港北区,日吉二丁目,0,29,14,15
2016/9/30,141097,港北区,日吉二丁目,1,31,17,14
2016/9/30,141097,港北区,日吉二丁目,2,15,9,6
2016/9/30,141097,港北区,日吉二丁目,3,20,9,11
2016/9/30,141097,港北区,日吉二丁目,4,22,15,7
2016/9/30,141097,港北区,日吉二丁目,5,20,9,11
2016/9/30,141097,港北区,日吉二丁目,6,15,6,9
2016/9/30,141097,港北区,日吉二丁目,7,15,4,11
2016/9/30,141097,港北区,日吉二丁目,8,13,9,4
2016/9/30,141097,港北区,日吉二丁目,9,15,7,8
2016/9/30,141097,港北区,日吉二丁目,10,10,6,4
2016/9/30,141097,港北区,日吉二丁目,11,13,6,7
2016/9/30,141097,港北区,日吉二丁目,12,20,10,10
2016/9/30,141097,港北区,日吉二丁目,13,7,5,2
2016/9/30,141097,港北区,日吉二丁目,14,16,7,9
2016/9/30,141097,港北区,日吉二丁目,15,17,12,5
2016/9/30,141097,港北区,日吉二丁目,16,19,13,6
2016/9/30,141097,港北区,日吉二丁目,17,15,6,9
2016/9/30,141097,港北区,日吉二丁目,18,19,9,10
2016/9/30,141097,港北区,日吉二丁目,19,22,9,13
2016/9/30,141097,港北区,日吉二丁目,20,46,22,24
2016/9/30,141097,港北区,日吉二丁目,21,52,32,20
2016/9/30,141097,港北区,日吉二丁目,22,56,27,29
2016/9/30,141097,港北区,日吉二丁目,23,61,35,26
2016/9/30,141097,港北区,日吉二丁目,24,61,33,28
2016/9/30,141097,港北区,日吉二丁目,25,56,33,23
2016/9/30,141097,港北区,日吉二丁目,26,73,35,38
2016/9/30,141097,港北区,日吉二丁目,27,69,33,36
2016/9/30,141097,港北区,日吉二丁目,28,67,33,34
2016/9/30,141097,港北区,日吉二丁目,29,62,39,23
2016/9/30,141097,港北区,日吉二丁目,30,81,35,46
2016/9/30,141097,港北区,日吉二丁目,31,65,32,33
2016/9/30,141097,港北区,日吉二丁目,32,67,41,26
2016/9/30,141097,港北区,日吉二丁目,33,56,28,28
2016/9/30,141097,港北区,日吉二丁目,34,50,27,23
2016/9/30,141097,港北区,日吉二丁目,35,50,27,23
2016/9/30,141097,港北区,日吉二丁目,36,51,27,24
2016/9/30,141097,港北区,日吉二丁目,37,51,24,27
2016/9/30,141097,港北区,日吉二丁目,38,46,22,24
2016/9/30,141097,港北区,日吉二丁目,39,60,38,22
2016/9/30,141097,港北区,日吉二丁目,40,46,27,19
2016/9/30,141097,港北区,日吉二丁目,41,51,36,15
2016/9/30,141097,港北区,日吉二丁目,42,44,21,23
2016/9/30,141097,港北区,日吉二丁目,43,46,22,24
2016/9/30,141097,港北区,日吉二丁目,44,43,23,20
2016/9/30,141097,港北区,日吉二丁目,45,32,14,18
2016/9/30,141097,港北区,日吉二丁目,46,36,20,16
2016/9/30,141097,港北区,日吉二丁目,47,49,29,20
2016/9/30,141097,港北区,日吉二丁目,48,43,19,24
2016/9/30,141097,港北区,日吉二丁目,49,41,18,23
2016/9/30,141097,港北区,日吉二丁目,50,22,9,13
2016/9/30,141097,港北区,日吉二丁目,51,39,16,23
2016/9/30,141097,港北区,日吉二丁目,52,35,18,17
2016/9/30,141097,港北区,日吉二丁目,53,41,24,17
2016/9/30,141097,港北区,日吉二丁目,54,45,23,22
2016/9/30,141097,港北区,日吉二丁目,55,23,7,16
2016/9/30,141097,港北区,日吉二丁目,56,26,16,10
2016/9/30,141097,港北区,日吉二丁目,57,33,16,17
2016/9/30,141097,港北区,日吉二丁目,58,19,8,11
2016/9/30,141097,港北区,日吉二丁目,59,29,14,15
2016/9/30,141097,港北区,日吉二丁目,60,27,16,11
2016/9/30,141097,港北区,日吉二丁目,61,29,20,9
2016/9/30,141097,港北区,日吉二丁目,62,29,18,11
2016/9/30,141097,港北区,日吉二丁目,63,43,15,28
2016/9/30,141097,港北区,日吉二丁目,64,25,10,15
2016/9/30,141097,港北区,日吉二丁目,65,32,13,19
2016/9/30,141097,港北区,日吉二丁目,66,25,15,10
2016/9/30,141097,港北区,日吉二丁目,67,42,18,24
2016/9/30,141097,港北区,日吉二丁目,68,47,21,26
2016/9/30,141097,港北区,日吉二丁目,69,41,18,23
2016/9/30,141097,港北区,日吉二丁目,70,26,14,12
2016/9/30,141097,港北区,日吉二丁目,71,17,7,10
2016/9/30,141097,港北区,日吉二丁目,72,29,13,16
2016/9/30,141097,港北区,日吉二丁目,73,22,11,11
2016/9/30,141097,港北区,日吉二丁目,74,21,8,13
2016/9/30,141097,港北区,日吉二丁目,75,34,12,22
2016/9/30,141097,港北区,日吉二丁目,76,25,8,17
2016/9/30,141097,港北区,日吉二丁目,77,20,10,10
2016/9/30,141097,港北区,日吉二丁目,78,19,10,9
2016/9/30,141097,港北区,日吉二丁目,79,25,12,13
2016/9/30,141097,港北区,日吉二丁目,80,21,7,14
2016/9/30,141097,港北区,日吉二丁目,81,14,8,6
2016/9/30,141097,港北区,日吉二丁目,82,18,6,12
2016/9/30,141097,港北区,日吉二丁目,83,12,5,7
2016/9/30,141097,港北区,日吉二丁目,84,17,7,10
2016/9/30,141097,港北区,日吉二丁目,85,12,4,8
2016/9/30,141097,港北区,日吉二丁目,86,17,7,10
2016/9/30,141097,港北区,日吉二丁目,87,13,2,11
2016/9/30,141097,港北区,日吉二丁目,88,9,3,6
2016/9/30,141097,港北区,日吉二丁目,89,7,0,7
2016/9/30,141097,港北区,日吉二丁目,90,5,1,4
2016/9/30,141097,港北区,日吉二丁目,91,9,3,6
2016/9/30,141097,港北区,日吉二丁目,92,2,0,2
2016/9/30,141097,港北区,日吉二丁目,93,4,2,2
2016/9/30,141097,港北区,日吉二丁目,94,9,1,8
2016/9/30,141097,港北区,日吉二丁目,95,4,1,3
2016/9/30,141097,港北区,日吉二丁目,96,5,3,2
2016/9/30,141097,港北区,日吉二丁目,97,2,0,2
2016/9/30,141097,港北区,日吉二丁目,98,0,0,0
2016/9/30,141097,港北区,日吉二丁目,99,1,1,0
2016/9/30,141097,港北区,日吉二丁目,100,0,0,0
2016/9/30,141097,港北区,日吉三丁目,合計,2424,1306,1118
2016/9/30,141097,港北区,日吉三丁目,0,26,10,16
2016/9/30,141097,港北区,日吉三丁目,1,21,13,8
2016/9/30,141097,港北区,日吉三丁目,2,13,6,7
2016/9/30,141097,港北区,日吉三丁目,3,19,9,10
2016/9/30,141097,港北区,日吉三丁目,4,9,4,5
2016/9/30,141097,港北区,日吉三丁目,5,14,5,9
2016/9/30,141097,港北区,日吉三丁目,6,11,8,3
2016/9/30,141097,港北区,日吉三丁目,7,9,5,4
2016/9/30,141097,港北区,日吉三丁目,8,7,4,3
2016/9/30,141097,港北区,日吉三丁目,9,14,3,11
2016/9/30,141097,港北区,日吉三丁目,10,6,4,2
2016/9/30,141097,港北区,日吉三丁目,11,13,5,8
2016/9/30,141097,港北区,日吉三丁目,12,15,9,6
2016/9/30,141097,港北区,日吉三丁目,13,18,14,4
2016/9/30,141097,港北区,日吉三丁目,14,16,5,11
2016/9/30,141097,港北区,日吉三丁目,15,8,3,5
2016/9/30,141097,港北区,日吉三丁目,16,15,8,7
2016/9/30,141097,港北区,日吉三丁目,17,18,10,8
2016/9/30,141097,港北区,日吉三丁目,18,19,13,6
2016/9/30,141097,港北区,日吉三丁目,19,21,14,7
2016/9/30,141097,港北区,日吉三丁目,20,30,19,11
2016/9/30,141097,港北区,日吉三丁目,21,41,28,13
2016/9/30,141097,港北区,日吉三丁目,22,49,31,18
2016/9/30,141097,港北区,日吉三丁目,23,59,34,25
2016/9/30,141097,港北区,日吉三丁目,24,61,35,26
2016/9/30,141097,港北区,日吉三丁目,25,58,35,23
2016/9/30,141097,港北区,日吉三丁目,26,61,43,18
2016/9/30,141097,港北区,日吉三丁目,27,59,30,29
2016/9/30,141097,港北区,日吉三丁目,28,57,33,24
2016/9/30,141097,港北区,日吉三丁目,29,60,33,27
2016/9/30,141097,港北区,日吉三丁目,30,66,36,30
2016/9/30,141097,港北区,日吉三丁目,31,74,42,32
2016/9/30,141097,港北区,日吉三丁目,32,38,19,19
2016/9/30,141097,港北区,日吉三丁目,33,55,31,24
2016/9/30,141097,港北区,日吉三丁目,34,55,38,17
2016/9/30,141097,港北区,日吉三丁目,35,47,30,17
2016/9/30,141097,港北区,日吉三丁目,36,45,27,18
2016/9/30,141097,港北区,日吉三丁目,37,47,24,23
2016/9/30,141097,港北区,日吉三丁目,38,57,37,20
2016/9/30,141097,港北区,日吉三丁目,39,44,20,24
2016/9/30,141097,港北区,日吉三丁目,40,53,37,16
2016/9/30,141097,港北区,日吉三丁目,41,40,24,16
2016/9/30,141097,港北区,日吉三丁目,42,24,10,14
2016/9/30,141097,港北区,日吉三丁目,43,43,25,18
2016/9/30,141097,港北区,日吉三丁目,44,44,26,18
2016/9/30,141097,港北区,日吉三丁目,45,41,22,19
2016/9/30,141097,港北区,日吉三丁目,46,31,17,14
2016/9/30,141097,港北区,日吉三丁目,47,41,23,18
2016/9/30,141097,港北区,日吉三丁目,48,45,19,26
2016/9/30,141097,港北区,日吉三丁目,49,32,16,16
2016/9/30,141097,港北区,日吉三丁目,50,27,17,10
2016/9/30,141097,港北区,日吉三丁目,51,26,15,11
2016/9/30,141097,港北区,日吉三丁目,52,28,14,14
2016/9/30,141097,港北区,日吉三丁目,53,22,14,8
2016/9/30,141097,港北区,日吉三丁目,54,25,11,14
2016/9/30,141097,港北区,日吉三丁目,55,22,11,11
2016/9/30,141097,港北区,日吉三丁目,56,17,8,9
2016/9/30,141097,港北区,日吉三丁目,57,25,15,10
2016/9/30,141097,港北区,日吉三丁目,58,22,13,9
2016/9/30,141097,港北区,日吉三丁目,59,18,6,12
2016/9/30,141097,港北区,日吉三丁目,60,14,5,9
2016/9/30,141097,港北区,日吉三丁目,61,16,13,3
2016/9/30,141097,港北区,日吉三丁目,62,17,6,11
2016/9/30,141097,港北区,日吉三丁目,63,16,9,7
2016/9/30,141097,港北区,日吉三丁目,64,19,9,10
2016/9/30,141097,港北区,日吉三丁目,65,14,4,10
2016/9/30,141097,港北区,日吉三丁目,66,18,10,8
2016/9/30,141097,港北区,日吉三丁目,67,25,14,11
2016/9/30,141097,港北区,日吉三丁目,68,24,11,13
2016/9/30,141097,港北区,日吉三丁目,69,15,6,9
2016/9/30,141097,港北区,日吉三丁目,70,13,6,7
2016/9/30,141097,港北区,日吉三丁目,71,9,5,4
2016/9/30,141097,港北区,日吉三丁目,72,14,8,6
2016/9/30,141097,港北区,日吉三丁目,73,23,11,12
2016/9/30,141097,港北区,日吉三丁目,74,17,7,10
2016/9/30,141097,港北区,日吉三丁目,75,15,5,10
2016/9/30,141097,港北区,日吉三丁目,76,25,9,16
2016/9/30,141097,港北区,日吉三丁目,77,7,4,3
2016/9/30,141097,港北区,日吉三丁目,78,12,4,8
2016/9/30,141097,港北区,日吉三丁目,79,9,3,6
2016/9/30,141097,港北区,日吉三丁目,80,18,8,10
2016/9/30,141097,港北区,日吉三丁目,81,16,9,7
2016/9/30,141097,港北区,日吉三丁目,82,12,0,12
2016/9/30,141097,港北区,日吉三丁目,83,15,3,12
2016/9/30,141097,港北区,日吉三丁目,84,12,4,8
2016/9/30,141097,港北区,日吉三丁目,85,12,3,9
2016/9/30,141097,港北区,日吉三丁目,86,8,1,7
2016/9/30,141097,港北区,日吉三丁目,87,7,1,6
2016/9/30,141097,港北区,日吉三丁目,88,7,2,5
2016/9/30,141097,港北区,日吉三丁目,89,2,1,1
2016/9/30,141097,港北区,日吉三丁目,90,3,2,1
2016/9/30,141097,港北区,日吉三丁目,91,3,1,2
2016/9/30,141097,港北区,日吉三丁目,92,2,1,1
2016/9/30,141097,港北区,日吉三丁目,93,0,0,0
2016/9/30,141097,港北区,日吉三丁目,94,2,0,2
2016/9/30,141097,港北区,日吉三丁目,95,0,0,0
2016/9/30,141097,港北区,日吉三丁目,96,0,0,0
2016/9/30,141097,港北区,日吉三丁目,97,0,0,0
2016/9/30,141097,港北区,日吉三丁目,98,1,0,1
2016/9/30,141097,港北区,日吉三丁目,99,1,1,0
2016/9/30,141097,港北区,日吉三丁目,100,0,0,0
2016/9/30,141097,港北区,日吉四丁目,合計,1949,1000,949
2016/9/30,141097,港北区,日吉四丁目,0,17,8,9
2016/9/30,141097,港北区,日吉四丁目,1,15,8,7
2016/9/30,141097,港北区,日吉四丁目,2,19,7,12
2016/9/30,141097,港北区,日吉四丁目,3,16,4,12
2016/9/30,141097,港北区,日吉四丁目,4,13,7,6
2016/9/30,141097,港北区,日吉四丁目,5,7,4,3
2016/9/30,141097,港北区,日吉四丁目,6,9,3,6
2016/9/30,141097,港北区,日吉四丁目,7,16,7,9
2016/9/30,141097,港北区,日吉四丁目,8,9,1,8
2016/9/30,141097,港北区,日吉四丁目,9,9,3,6
2016/9/30,141097,港北区,日吉四丁目,10,8,2,6
2016/9/30,141097,港北区,日吉四丁目,11,10,4,6
2016/9/30,141097,港北区,日吉四丁目,12,11,5,6
2016/9/30,141097,港北区,日吉四丁目,13,10,7,3
2016/9/30,141097,港北区,日吉四丁目,14,14,5,9
2016/9/30,141097,港北区,日吉四丁目,15,12,9,3
2016/9/30,141097,港北区,日吉四丁目,16,9,5,4
2016/9/30,141097,港北区,日吉四丁目,17,11,7,4
2016/9/30,141097,港北区,日吉四丁目,18,15,9,6
2016/9/30,141097,港北区,日吉四丁目,19,21,10,11
2016/9/30,141097,港北区,日吉四丁目,20,28,16,12
2016/9/30,141097,港北区,日吉四丁目,21,35,20,15
2016/9/30,141097,港北区,日吉四丁目,22,53,40,13
2016/9/30,141097,港北区,日吉四丁目,23,44,32,12
2016/9/30,141097,港北区,日吉四丁目,24,36,25,11
2016/9/30,141097,港北区,日吉四丁目,25,39,20,19
2016/9/30,141097,港北区,日吉四丁目,26,57,30,27
2016/9/30,141097,港北区,日吉四丁目,27,44,20,24
2016/9/30,141097,港北区,日吉四丁目,28,52,27,25
2016/9/30,141097,港北区,日吉四丁目,29,53,30,23
2016/9/30,141097,港北区,日吉四丁目,30,46,30,16
2016/9/30,141097,港北区,日吉四丁目,31,47,23,24
2016/9/30,141097,港北区,日吉四丁目,32,49,30,19
2016/9/30,141097,港北区,日吉四丁目,33,33,20,13
2016/9/30,141097,港北区,日吉四丁目,34,24,12,12
2016/9/30,141097,港北区,日吉四丁目,35,35,20,15
2016/9/30,141097,港北区,日吉四丁目,36,33,17,16
2016/9/30,141097,港北区,日吉四丁目,37,26,11,15
2016/9/30,141097,港北区,日吉四丁目,38,34,16,18
2016/9/30,141097,港北区,日吉四丁目,39,30,19,11
2016/9/30,141097,港北区,日吉四丁目,40,29,12,17
2016/9/30,141097,港北区,日吉四丁目,41,27,15,12
2016/9/30,141097,港北区,日吉四丁目,42,28,9,19
2016/9/30,141097,港北区,日吉四丁目,43,29,15,14
2016/9/30,141097,港北区,日吉四丁目,44,31,16,15
2016/9/30,141097,港北区,日吉四丁目,45,25,16,9
2016/9/30,141097,港北区,日吉四丁目,46,37,18,19
2016/9/30,141097,港北区,日吉四丁目,47,34,21,13
2016/9/30,141097,港北区,日吉四丁目,48,28,13,15
2016/9/30,141097,港北区,日吉四丁目,49,22,11,11
2016/9/30,141097,港北区,日吉四丁目,50,19,10,9
2016/9/30,141097,港北区,日吉四丁目,51,24,15,9
2016/9/30,141097,港北区,日吉四丁目,52,27,14,13
2016/9/30,141097,港北区,日吉四丁目,53,28,12,16
2016/9/30,141097,港北区,日吉四丁目,54,17,10,7
2016/9/30,141097,港北区,日吉四丁目,55,18,6,12
2016/9/30,141097,港北区,日吉四丁目,56,25,8,17
2016/9/30,141097,港北区,日吉四丁目,57,25,18,7
2016/9/30,141097,港北区,日吉四丁目,58,22,11,11
2016/9/30,141097,港北区,日吉四丁目,59,9,6,3
2016/9/30,141097,港北区,日吉四丁目,60,11,8,3
2016/9/30,141097,港北区,日吉四丁目,61,19,6,13
2016/9/30,141097,港北区,日吉四丁目,62,14,5,9
2016/9/30,141097,港北区,日吉四丁目,63,15,8,7
2016/9/30,141097,港北区,日吉四丁目,64,10,5,5
2016/9/30,141097,港北区,日吉四丁目,65,22,17,5
2016/9/30,141097,港北区,日吉四丁目,66,14,6,8
2016/9/30,141097,港北区,日吉四丁目,67,16,6,10
2016/9/30,141097,港北区,日吉四丁目,68,17,9,8
2016/9/30,141097,港北区,日吉四丁目,69,16,3,13
2016/9/30,141097,港北区,日吉四丁目,70,9,5,4
2016/9/30,141097,港北区,日吉四丁目,71,14,8,6
2016/9/30,141097,港北区,日吉四丁目,72,22,12,10
2016/9/30,141097,港北区,日吉四丁目,73,14,6,8
2016/9/30,141097,港北区,日吉四丁目,74,16,5,11
2016/9/30,141097,港北区,日吉四丁目,75,9,0,9
2016/9/30,141097,港北区,日吉四丁目,76,13,7,6
2016/9/30,141097,港北区,日吉四丁目,77,16,8,8
2016/9/30,141097,港北区,日吉四丁目,78,16,5,11
2016/9/30,141097,港北区,日吉四丁目,79,13,4,9
2016/9/30,141097,港北区,日吉四丁目,80,5,2,3
2016/9/30,141097,港北区,日吉四丁目,81,8,4,4
2016/9/30,141097,港北区,日吉四丁目,82,13,4,9
2016/9/30,141097,港北区,日吉四丁目,83,7,3,4
2016/9/30,141097,港北区,日吉四丁目,84,13,5,8
2016/9/30,141097,港北区,日吉四丁目,85,8,2,6
2016/9/30,141097,港北区,日吉四丁目,86,10,7,3
2016/9/30,141097,港北区,日吉四丁目,87,7,1,6
2016/9/30,141097,港北区,日吉四丁目,88,10,4,6
2016/9/30,141097,港北区,日吉四丁目,89,6,3,3
2016/9/30,141097,港北区,日吉四丁目,90,1,0,1
2016/9/30,141097,港北区,日吉四丁目,91,2,0,2
2016/9/30,141097,港北区,日吉四丁目,92,3,2,1
2016/9/30,141097,港北区,日吉四丁目,93,1,0,1
2016/9/30,141097,港北区,日吉四丁目,94,2,0,2
2016/9/30,141097,港北区,日吉四丁目,95,1,0,1
2016/9/30,141097,港北区,日吉四丁目,96,2,1,1
2016/9/30,141097,港北区,日吉四丁目,97,0,0,0
2016/9/30,141097,港北区,日吉四丁目,98,1,0,1
2016/9/30,141097,港北区,日吉四丁目,99,0,0,0
2016/9/30,141097,港北区,日吉四丁目,100,0,0,0
2016/9/30,141097,港北区,日吉五丁目,合計,4403,2274,2129
2016/9/30,141097,港北区,日吉五丁目,0,57,33,24
2016/9/30,141097,港北区,日吉五丁目,1,62,23,39
2016/9/30,141097,港北区,日吉五丁目,2,46,29,17
2016/9/30,141097,港北区,日吉五丁目,3,42,15,27
2016/9/30,141097,港北区,日吉五丁目,4,30,16,14
2016/9/30,141097,港北区,日吉五丁目,5,39,15,24
2016/9/30,141097,港北区,日吉五丁目,6,35,17,18
2016/9/30,141097,港北区,日吉五丁目,7,25,16,9
2016/9/30,141097,港北区,日吉五丁目,8,24,11,13
2016/9/30,141097,港北区,日吉五丁目,9,36,16,20
2016/9/30,141097,港北区,日吉五丁目,10,29,14,15
2016/9/30,141097,港北区,日吉五丁目,11,31,8,23
2016/9/30,141097,港北区,日吉五丁目,12,28,18,10
2016/9/30,141097,港北区,日吉五丁目,13,34,12,22
2016/9/30,141097,港北区,日吉五丁目,14,24,11,13
2016/9/30,141097,港北区,日吉五丁目,15,30,16,14
2016/9/30,141097,港北区,日吉五丁目,16,36,19,17
2016/9/30,141097,港北区,日吉五丁目,17,29,14,15
2016/9/30,141097,港北区,日吉五丁目,18,45,22,23
2016/9/30,141097,港北区,日吉五丁目,19,54,32,22
2016/9/30,141097,港北区,日吉五丁目,20,50,26,24
2016/9/30,141097,港北区,日吉五丁目,21,48,27,21
2016/9/30,141097,港北区,日吉五丁目,22,67,38,29
2016/9/30,141097,港北区,日吉五丁目,23,64,37,27
2016/9/30,141097,港北区,日吉五丁目,24,59,39,20
2016/9/30,141097,港北区,日吉五丁目,25,67,30,37
2016/9/30,141097,港北区,日吉五丁目,26,68,39,29
2016/9/30,141097,港北区,日吉五丁目,27,82,46,36
2016/9/30,141097,港北区,日吉五丁目,28,80,37,43
2016/9/30,141097,港北区,日吉五丁目,29,76,41,35
2016/9/30,141097,港北区,日吉五丁目,30,94,50,44
2016/9/30,141097,港北区,日吉五丁目,31,114,62,52
2016/9/30,141097,港北区,日吉五丁目,32,85,41,44
2016/9/30,141097,港北区,日吉五丁目,33,88,44,44
2016/9/30,141097,港北区,日吉五丁目,34,85,48,37
2016/9/30,141097,港北区,日吉五丁目,35,89,54,35
2016/9/30,141097,港北区,日吉五丁目,36,61,27,34
2016/9/30,141097,港北区,日吉五丁目,37,80,37,43
2016/9/30,141097,港北区,日吉五丁目,38,78,46,32
2016/9/30,141097,港北区,日吉五丁目,39,65,36,29
2016/9/30,141097,港北区,日吉五丁目,40,91,50,41
2016/9/30,141097,港北区,日吉五丁目,41,65,32,33
2016/9/30,141097,港北区,日吉五丁目,42,86,46,40
2016/9/30,141097,港北区,日吉五丁目,43,78,49,29
2016/9/30,141097,港北区,日吉五丁目,44,73,39,34
2016/9/30,141097,港北区,日吉五丁目,45,82,43,39
2016/9/30,141097,港北区,日吉五丁目,46,86,47,39
2016/9/30,141097,港北区,日吉五丁目,47,74,42,32
2016/9/30,141097,港北区,日吉五丁目,48,67,33,34
2016/9/30,141097,港北区,日吉五丁目,49,68,36,32
2016/9/30,141097,港北区,日吉五丁目,50,55,32,23
2016/9/30,141097,港北区,日吉五丁目,51,86,43,43
2016/9/30,141097,港北区,日吉五丁目,52,75,43,32
2016/9/30,141097,港北区,日吉五丁目,53,63,36,27
2016/9/30,141097,港北区,日吉五丁目,54,78,46,32
2016/9/30,141097,港北区,日吉五丁目,55,55,26,29
2016/9/30,141097,港北区,日吉五丁目,56,59,31,28
2016/9/30,141097,港北区,日吉五丁目,57,50,28,22
2016/9/30,141097,港北区,日吉五丁目,58,49,19,30
2016/9/30,141097,港北区,日吉五丁目,59,41,21,20
2016/9/30,141097,港北区,日吉五丁目,60,39,16,23
2016/9/30,141097,港北区,日吉五丁目,61,44,21,23
2016/9/30,141097,港北区,日吉五丁目,62,39,24,15
2016/9/30,141097,港北区,日吉五丁目,63,41,24,17
2016/9/30,141097,港北区,日吉五丁目,64,34,19,15
2016/9/30,141097,港北区,日吉五丁目,65,50,25,25
2016/9/30,141097,港北区,日吉五丁目,66,41,20,21
2016/9/30,141097,港北区,日吉五丁目,67,37,21,16
2016/9/30,141097,港北区,日吉五丁目,68,39,19,20
2016/9/30,141097,港北区,日吉五丁目,69,37,20,17
2016/9/30,141097,港北区,日吉五丁目,70,23,9,14
2016/9/30,141097,港北区,日吉五丁目,71,13,8,5
2016/9/30,141097,港北区,日吉五丁目,72,29,17,12
2016/9/30,141097,港北区,日吉五丁目,73,25,9,16
2016/9/30,141097,港北区,日吉五丁目,74,25,9,16
2016/9/30,141097,港北区,日吉五丁目,75,36,18,18
2016/9/30,141097,港北区,日吉五丁目,76,19,7,12
2016/9/30,141097,港北区,日吉五丁目,77,27,12,15
2016/9/30,141097,港北区,日吉五丁目,78,19,6,13
2016/9/30,141097,港北区,日吉五丁目,79,22,7,15
2016/9/30,141097,港北区,日吉五丁目,80,16,8,8
2016/9/30,141097,港北区,日吉五丁目,81,17,9,8
2016/9/30,141097,港北区,日吉五丁目,82,17,9,8
2016/9/30,141097,港北区,日吉五丁目,83,16,9,7
2016/9/30,141097,港北区,日吉五丁目,84,7,1,6
2016/9/30,141097,港北区,日吉五丁目,85,10,2,8
2016/9/30,141097,港北区,日吉五丁目,86,10,4,6
2016/9/30,141097,港北区,日吉五丁目,87,11,5,6
2016/9/30,141097,港北区,日吉五丁目,88,13,5,8
2016/9/30,141097,港北区,日吉五丁目,89,7,2,5
2016/9/30,141097,港北区,日吉五丁目,90,7,2,5
2016/9/30,141097,港北区,日吉五丁目,91,2,0,2
2016/9/30,141097,港北区,日吉五丁目,92,4,0,4
2016/9/30,141097,港北区,日吉五丁目,93,5,2,3
2016/9/30,141097,港北区,日吉五丁目,94,1,0,1
2016/9/30,141097,港北区,日吉五丁目,95,2,1,1
2016/9/30,141097,港北区,日吉五丁目,96,1,0,1
2016/9/30,141097,港北区,日吉五丁目,97,1,0,1
2016/9/30,141097,港北区,日吉五丁目,98,0,0,0
2016/9/30,141097,港北区,日吉五丁目,99,0,0,0
2016/9/30,141097,港北区,日吉五丁目,100,0,0,0
2016/9/30,141097,港北区,日吉六丁目,合計,2947,1527,1420
2016/9/30,141097,港北区,日吉六丁目,0,41,22,19
2016/9/30,141097,港北区,日吉六丁目,1,31,16,15
2016/9/30,141097,港北区,日吉六丁目,2,34,20,14
2016/9/30,141097,港北区,日吉六丁目,3,36,20,16
2016/9/30,141097,港北区,日吉六丁目,4,38,20,18
2016/9/30,141097,港北区,日吉六丁目,5,33,13,20
2016/9/30,141097,港北区,日吉六丁目,6,29,18,11
2016/9/30,141097,港北区,日吉六丁目,7,37,19,18
2016/9/30,141097,港北区,日吉六丁目,8,31,13,18
2016/9/30,141097,港北区,日吉六丁目,9,35,23,12
2016/9/30,141097,港北区,日吉六丁目,10,22,9,13
2016/9/30,141097,港北区,日吉六丁目,11,21,11,10
2016/9/30,141097,港北区,日吉六丁目,12,32,14,18
2016/9/30,141097,港北区,日吉六丁目,13,33,18,15
2016/9/30,141097,港北区,日吉六丁目,14,28,16,12
2016/9/30,141097,港北区,日吉六丁目,15,27,14,13
2016/9/30,141097,港北区,日吉六丁目,16,20,10,10
2016/9/30,141097,港北区,日吉六丁目,17,32,15,17
2016/9/30,141097,港北区,日吉六丁目,18,23,8,15
2016/9/30,141097,港北区,日吉六丁目,19,20,10,10
2016/9/30,141097,港北区,日吉六丁目,20,30,12,18
2016/9/30,141097,港北区,日吉六丁目,21,37,22,15
2016/9/30,141097,港北区,日吉六丁目,22,36,22,14
2016/9/30,141097,港北区,日吉六丁目,23,45,29,16
2016/9/30,141097,港北区,日吉六丁目,24,29,14,15
2016/9/30,141097,港北区,日吉六丁目,25,29,16,13
2016/9/30,141097,港北区,日吉六丁目,26,25,14,11
2016/9/30,141097,港北区,日吉六丁目,27,47,18,29
2016/9/30,141097,港北区,日吉六丁目,28,40,23,17
2016/9/30,141097,港北区,日吉六丁目,29,44,28,16
2016/9/30,141097,港北区,日吉六丁目,30,49,20,29
2016/9/30,141097,港北区,日吉六丁目,31,49,28,21
2016/9/30,141097,港北区,日吉六丁目,32,63,32,31
2016/9/30,141097,港北区,日吉六丁目,33,56,26,30
2016/9/30,141097,港北区,日吉六丁目,34,60,37,23
2016/9/30,141097,港北区,日吉六丁目,35,55,27,28
2016/9/30,141097,港北区,日吉六丁目,36,46,27,19
2016/9/30,141097,港北区,日吉六丁目,37,51,21,30
2016/9/30,141097,港北区,日吉六丁目,38,49,26,23
2016/9/30,141097,港北区,日吉六丁目,39,56,33,23
2016/9/30,141097,港北区,日吉六丁目,40,71,36,35
2016/9/30,141097,港北区,日吉六丁目,41,67,38,29
2016/9/30,141097,港北区,日吉六丁目,42,54,27,27
2016/9/30,141097,港北区,日吉六丁目,43,55,29,26
2016/9/30,141097,港北区,日吉六丁目,44,58,31,27
2016/9/30,141097,港北区,日吉六丁目,45,50,21,29
2016/9/30,141097,港北区,日吉六丁目,46,57,32,25
2016/9/30,141097,港北区,日吉六丁目,47,49,29,20
2016/9/30,141097,港北区,日吉六丁目,48,52,31,21
2016/9/30,141097,港北区,日吉六丁目,49,53,33,20
2016/9/30,141097,港北区,日吉六丁目,50,55,27,28
2016/9/30,141097,港北区,日吉六丁目,51,49,23,26
2016/9/30,141097,港北区,日吉六丁目,52,41,23,18
2016/9/30,141097,港北区,日吉六丁目,53,37,14,23
2016/9/30,141097,港北区,日吉六丁目,54,38,21,17
2016/9/30,141097,港北区,日吉六丁目,55,28,18,10
2016/9/30,141097,港北区,日吉六丁目,56,35,21,14
2016/9/30,141097,港北区,日吉六丁目,57,36,14,22
2016/9/30,141097,港北区,日吉六丁目,58,28,15,13
2016/9/30,141097,港北区,日吉六丁目,59,20,11,9
2016/9/30,141097,港北区,日吉六丁目,60,18,8,10
2016/9/30,141097,港北区,日吉六丁目,61,29,14,15
2016/9/30,141097,港北区,日吉六丁目,62,22,11,11
2016/9/30,141097,港北区,日吉六丁目,63,28,15,13
2016/9/30,141097,港北区,日吉六丁目,64,23,16,7
2016/9/30,141097,港北区,日吉六丁目,65,26,18,8
2016/9/30,141097,港北区,日吉六丁目,66,22,10,12
2016/9/30,141097,港北区,日吉六丁目,67,26,12,14
2016/9/30,141097,港北区,日吉六丁目,68,32,20,12
2016/9/30,141097,港北区,日吉六丁目,69,23,10,13
2016/9/30,141097,港北区,日吉六丁目,70,15,6,9
2016/9/30,141097,港北区,日吉六丁目,71,17,9,8
2016/9/30,141097,港北区,日吉六丁目,72,16,9,7
2016/9/30,141097,港北区,日吉六丁目,73,27,12,15
2016/9/30,141097,港北区,日吉六丁目,74,19,13,6
2016/9/30,141097,港北区,日吉六丁目,75,15,4,11
2016/9/30,141097,港北区,日吉六丁目,76,21,11,10
2016/9/30,141097,港北区,日吉六丁目,77,20,8,12
2016/9/30,141097,港北区,日吉六丁目,78,17,7,10
2016/9/30,141097,港北区,日吉六丁目,79,15,5,10
2016/9/30,141097,港北区,日吉六丁目,80,12,6,6
2016/9/30,141097,港北区,日吉六丁目,81,7,2,5
2016/9/30,141097,港北区,日吉六丁目,82,10,2,8
2016/9/30,141097,港北区,日吉六丁目,83,17,10,7
2016/9/30,141097,港北区,日吉六丁目,84,8,4,4
2016/9/30,141097,港北区,日吉六丁目,85,9,4,5
2016/9/30,141097,港北区,日吉六丁目,86,6,3,3
2016/9/30,141097,港北区,日吉六丁目,87,1,0,1
2016/9/30,141097,港北区,日吉六丁目,88,5,0,5
2016/9/30,141097,港北区,日吉六丁目,89,1,0,1
2016/9/30,141097,港北区,日吉六丁目,90,4,0,4
2016/9/30,141097,港北区,日吉六丁目,91,0,0,0
2016/9/30,141097,港北区,日吉六丁目,92,1,0,1
2016/9/30,141097,港北区,日吉六丁目,93,0,0,0
2016/9/30,141097,港北区,日吉六丁目,94,1,0,1
2016/9/30,141097,港北区,日吉六丁目,95,1,0,1
2016/9/30,141097,港北区,日吉六丁目,96,0,0,0
2016/9/30,141097,港北区,日吉六丁目,97,0,0,0
2016/9/30,141097,港北区,日吉六丁目,98,0,0,0
2016/9/30,141097,港北区,日吉六丁目,99,0,0,0
2016/9/30,141097,港北区,日吉六丁目,100,1,0,1
2016/9/30,141097,港北区,日吉七丁目,合計,4433,2276,2157
2016/9/30,141097,港北区,日吉七丁目,0,52,21,31
2016/9/30,141097,港北区,日吉七丁目,1,64,33,31
2016/9/30,141097,港北区,日吉七丁目,2,58,28,30
2016/9/30,141097,港北区,日吉七丁目,3,54,31,23
2016/9/30,141097,港北区,日吉七丁目,4,48,23,25
2016/9/30,141097,港北区,日吉七丁目,5,38,21,17
2016/9/30,141097,港北区,日吉七丁目,6,43,23,20
2016/9/30,141097,港北区,日吉七丁目,7,29,17,12
2016/9/30,141097,港北区,日吉七丁目,8,40,19,21
2016/9/30,141097,港北区,日吉七丁目,9,36,17,19
2016/9/30,141097,港北区,日吉七丁目,10,24,12,12
2016/9/30,141097,港北区,日吉七丁目,11,31,15,16
2016/9/30,141097,港北区,日吉七丁目,12,35,18,17
2016/9/30,141097,港北区,日吉七丁目,13,26,16,10
2016/9/30,141097,港北区,日吉七丁目,14,23,11,12
2016/9/30,141097,港北区,日吉七丁目,15,26,14,12
2016/9/30,141097,港北区,日吉七丁目,16,27,15,12
2016/9/30,141097,港北区,日吉七丁目,17,16,7,9
2016/9/30,141097,港北区,日吉七丁目,18,30,14,16
2016/9/30,141097,港北区,日吉七丁目,19,37,19,18
2016/9/30,141097,港北区,日吉七丁目,20,38,22,16
2016/9/30,141097,港北区,日吉七丁目,21,58,30,28
2016/9/30,141097,港北区,日吉七丁目,22,43,28,15
2016/9/30,141097,港北区,日吉七丁目,23,59,30,29
2016/9/30,141097,港北区,日吉七丁目,24,71,39,32
2016/9/30,141097,港北区,日吉七丁目,25,48,26,22
2016/9/30,141097,港北区,日吉七丁目,26,66,37,29
2016/9/30,141097,港北区,日吉七丁目,27,57,34,23
2016/9/30,141097,港北区,日吉七丁目,28,60,29,31
2016/9/30,141097,港北区,日吉七丁目,29,67,32,35
2016/9/30,141097,港北区,日吉七丁目,30,75,42,33
2016/9/30,141097,港北区,日吉七丁目,31,87,48,39
2016/9/30,141097,港北区,日吉七丁目,32,78,42,36
2016/9/30,141097,港北区,日吉七丁目,33,88,38,50
2016/9/30,141097,港北区,日吉七丁目,34,76,37,39
2016/9/30,141097,港北区,日吉七丁目,35,76,43,33
2016/9/30,141097,港北区,日吉七丁目,36,109,49,60
2016/9/30,141097,港北区,日吉七丁目,37,86,42,44
2016/9/30,141097,港北区,日吉七丁目,38,82,54,28
2016/9/30,141097,港北区,日吉七丁目,39,86,47,39
2016/9/30,141097,港北区,日吉七丁目,40,98,48,50
2016/9/30,141097,港北区,日吉七丁目,41,82,33,49
2016/9/30,141097,港北区,日吉七丁目,42,87,43,44
2016/9/30,141097,港北区,日吉七丁目,43,80,45,35
2016/9/30,141097,港北区,日吉七丁目,44,85,45,40
2016/9/30,141097,港北区,日吉七丁目,45,81,44,37
2016/9/30,141097,港北区,日吉七丁目,46,84,42,42
2016/9/30,141097,港北区,日吉七丁目,47,71,41,30
2016/9/30,141097,港北区,日吉七丁目,48,85,48,37
2016/9/30,141097,港北区,日吉七丁目,49,60,35,25
2016/9/30,141097,港北区,日吉七丁目,50,54,36,18
2016/9/30,141097,港北区,日吉七丁目,51,60,31,29
2016/9/30,141097,港北区,日吉七丁目,52,64,40,24
2016/9/30,141097,港北区,日吉七丁目,53,59,35,24
2016/9/30,141097,港北区,日吉七丁目,54,51,29,22
2016/9/30,141097,港北区,日吉七丁目,55,44,27,17
2016/9/30,141097,港北区,日吉七丁目,56,59,29,30
2016/9/30,141097,港北区,日吉七丁目,57,49,25,24
2016/9/30,141097,港北区,日吉七丁目,58,41,24,17
2016/9/30,141097,港北区,日吉七丁目,59,42,22,20
2016/9/30,141097,港北区,日吉七丁目,60,38,22,16
2016/9/30,141097,港北区,日吉七丁目,61,46,18,28
2016/9/30,141097,港北区,日吉七丁目,62,47,19,28
2016/9/30,141097,港北区,日吉七丁目,63,54,34,20
2016/9/30,141097,港北区,日吉七丁目,64,44,23,21
2016/9/30,141097,港北区,日吉七丁目,65,36,18,18
2016/9/30,141097,港北区,日吉七丁目,66,41,14,27
2016/9/30,141097,港北区,日吉七丁目,67,38,17,21
2016/9/30,141097,港北区,日吉七丁目,68,43,19,24
2016/9/30,141097,港北区,日吉七丁目,69,51,25,26
2016/9/30,141097,港北区,日吉七丁目,70,34,13,21
2016/9/30,141097,港北区,日吉七丁目,71,29,17,12
2016/9/30,141097,港北区,日吉七丁目,72,44,23,21
2016/9/30,141097,港北区,日吉七丁目,73,46,19,27
2016/9/30,141097,港北区,日吉七丁目,74,45,19,26
2016/9/30,141097,港北区,日吉七丁目,75,30,12,18
2016/9/30,141097,港北区,日吉七丁目,76,27,11,16
2016/9/30,141097,港北区,日吉七丁目,77,27,13,14
2016/9/30,141097,港北区,日吉七丁目,78,26,15,11
2016/9/30,141097,港北区,日吉七丁目,79,20,7,13
2016/9/30,141097,港北区,日吉七丁目,80,34,13,21
2016/9/30,141097,港北区,日吉七丁目,81,31,10,21
2016/9/30,141097,港北区,日吉七丁目,82,18,9,9
2016/9/30,141097,港北区,日吉七丁目,83,21,13,8
2016/9/30,141097,港北区,日吉七丁目,84,15,9,6
2016/9/30,141097,港北区,日吉七丁目,85,9,2,7
2016/9/30,141097,港北区,日吉七丁目,86,10,4,6
2016/9/30,141097,港北区,日吉七丁目,87,10,3,7
2016/9/30,141097,港北区,日吉七丁目,88,8,2,6
2016/9/30,141097,港北区,日吉七丁目,89,2,2,0
2016/9/30,141097,港北区,日吉七丁目,90,8,1,7
2016/9/30,141097,港北区,日吉七丁目,91,6,2,4
2016/9/30,141097,港北区,日吉七丁目,92,1,0,1
2016/9/30,141097,港北区,日吉七丁目,93,2,1,1
2016/9/30,141097,港北区,日吉七丁目,94,2,1,1
2016/9/30,141097,港北区,日吉七丁目,95,2,1,1
2016/9/30,141097,港北区,日吉七丁目,96,2,0,2
2016/9/30,141097,港北区,日吉七丁目,97,1,0,1
2016/9/30,141097,港北区,日吉七丁目,98,0,0,0
2016/9/30,141097,港北区,日吉七丁目,99,1,0,1
2016/9/30,141097,港北区,日吉七丁目,100,1,0,1
2016/9/30,141097,港北区,日吉本町一丁目,合計,3084,1459,1625
2016/9/30,141097,港北区,日吉本町一丁目,0,29,18,11
2016/9/30,141097,港北区,日吉本町一丁目,1,24,10,14
2016/9/30,141097,港北区,日吉本町一丁目,2,17,8,9
2016/9/30,141097,港北区,日吉本町一丁目,3,7,3,4
2016/9/30,141097,港北区,日吉本町一丁目,4,29,16,13
2016/9/30,141097,港北区,日吉本町一丁目,5,27,15,12
2016/9/30,141097,港北区,日吉本町一丁目,6,14,7,7
2016/9/30,141097,港北区,日吉本町一丁目,7,11,6,5
2016/9/30,141097,港北区,日吉本町一丁目,8,16,7,9
2016/9/30,141097,港北区,日吉本町一丁目,9,9,8,1
2016/9/30,141097,港北区,日吉本町一丁目,10,14,10,4
2016/9/30,141097,港北区,日吉本町一丁目,11,8,2,6
2016/9/30,141097,港北区,日吉本町一丁目,12,11,6,5
2016/9/30,141097,港北区,日吉本町一丁目,13,9,7,2
2016/9/30,141097,港北区,日吉本町一丁目,14,20,10,10
2016/9/30,141097,港北区,日吉本町一丁目,15,15,9,6
2016/9/30,141097,港北区,日吉本町一丁目,16,18,7,11
2016/9/30,141097,港北区,日吉本町一丁目,17,24,10,14
2016/9/30,141097,港北区,日吉本町一丁目,18,23,10,13
2016/9/30,141097,港北区,日吉本町一丁目,19,31,17,14
2016/9/30,141097,港北区,日吉本町一丁目,20,41,21,20
2016/9/30,141097,港北区,日吉本町一丁目,21,45,22,23
2016/9/30,141097,港北区,日吉本町一丁目,22,60,30,30
2016/9/30,141097,港北区,日吉本町一丁目,23,57,19,38
2016/9/30,141097,港北区,日吉本町一丁目,24,64,26,38
2016/9/30,141097,港北区,日吉本町一丁目,25,54,29,25
2016/9/30,141097,港北区,日吉本町一丁目,26,57,20,37
2016/9/30,141097,港北区,日吉本町一丁目,27,67,37,30
2016/9/30,141097,港北区,日吉本町一丁目,28,44,21,23
2016/9/30,141097,港北区,日吉本町一丁目,29,57,29,28
2016/9/30,141097,港北区,日吉本町一丁目,30,58,29,29
2016/9/30,141097,港北区,日吉本町一丁目,31,56,26,30
2016/9/30,141097,港北区,日吉本町一丁目,32,49,27,22
2016/9/30,141097,港北区,日吉本町一丁目,33,44,14,30
2016/9/30,141097,港北区,日吉本町一丁目,34,55,36,19
2016/9/30,141097,港北区,日吉本町一丁目,35,50,23,27
2016/9/30,141097,港北区,日吉本町一丁目,36,66,36,30
2016/9/30,141097,港北区,日吉本町一丁目,37,67,35,32
2016/9/30,141097,港北区,日吉本町一丁目,38,42,20,22
2016/9/30,141097,港北区,日吉本町一丁目,39,46,26,20
2016/9/30,141097,港北区,日吉本町一丁目,40,40,19,21
2016/9/30,141097,港北区,日吉本町一丁目,41,23,13,10
2016/9/30,141097,港北区,日吉本町一丁目,42,49,24,25
2016/9/30,141097,港北区,日吉本町一丁目,43,46,19,27
2016/9/30,141097,港北区,日吉本町一丁目,44,58,21,37
2016/9/30,141097,港北区,日吉本町一丁目,45,52,28,24
2016/9/30,141097,港北区,日吉本町一丁目,46,62,30,32
2016/9/30,141097,港北区,日吉本町一丁目,47,54,29,25
2016/9/30,141097,港北区,日吉本町一丁目,48,35,12,23
2016/9/30,141097,港北区,日吉本町一丁目,49,45,23,22
2016/9/30,141097,港北区,日吉本町一丁目,50,40,21,19
2016/9/30,141097,港北区,日吉本町一丁目,51,48,28,20
2016/9/30,141097,港北区,日吉本町一丁目,52,38,19,19
2016/9/30,141097,港北区,日吉本町一丁目,53,44,22,22
2016/9/30,141097,港北区,日吉本町一丁目,54,41,22,19
2016/9/30,141097,港北区,日吉本町一丁目,55,49,23,26
2016/9/30,141097,港北区,日吉本町一丁目,56,34,17,17
2016/9/30,141097,港北区,日吉本町一丁目,57,31,8,23
2016/9/30,141097,港北区,日吉本町一丁目,58,39,23,16
2016/9/30,141097,港北区,日吉本町一丁目,59,24,13,11
2016/9/30,141097,港北区,日吉本町一丁目,60,26,11,15
2016/9/30,141097,港北区,日吉本町一丁目,61,25,16,9
2016/9/30,141097,港北区,日吉本町一丁目,62,28,16,12
2016/9/30,141097,港北区,日吉本町一丁目,63,26,12,14
2016/9/30,141097,港北区,日吉本町一丁目,64,29,9,20
2016/9/30,141097,港北区,日吉本町一丁目,65,31,15,16
2016/9/30,141097,港北区,日吉本町一丁目,66,45,21,24
2016/9/30,141097,港北区,日吉本町一丁目,67,35,11,24
2016/9/30,141097,港北区,日吉本町一丁目,68,42,19,23
2016/9/30,141097,港北区,日吉本町一丁目,69,51,26,25
2016/9/30,141097,港北区,日吉本町一丁目,70,17,8,9
2016/9/30,141097,港北区,日吉本町一丁目,71,20,7,13
2016/9/30,141097,港北区,日吉本町一丁目,72,24,10,14
2016/9/30,141097,港北区,日吉本町一丁目,73,40,13,27
2016/9/30,141097,港北区,日吉本町一丁目,74,30,8,22
2016/9/30,141097,港北区,日吉本町一丁目,75,34,18,16
2016/9/30,141097,港北区,日吉本町一丁目,76,23,7,16
2016/9/30,141097,港北区,日吉本町一丁目,77,23,9,14
2016/9/30,141097,港北区,日吉本町一丁目,78,26,9,17
2016/9/30,141097,港北区,日吉本町一丁目,79,21,11,10
2016/9/30,141097,港北区,日吉本町一丁目,80,23,8,15
2016/9/30,141097,港北区,日吉本町一丁目,81,12,9,3
2016/9/30,141097,港北区,日吉本町一丁目,82,17,9,8
2016/9/30,141097,港北区,日吉本町一丁目,83,17,6,11
2016/9/30,141097,港北区,日吉本町一丁目,84,15,7,8
2016/9/30,141097,港北区,日吉本町一丁目,85,16,4,12
2016/9/30,141097,港北区,日吉本町一丁目,86,19,7,12
2016/9/30,141097,港北区,日吉本町一丁目,87,11,1,10
2016/9/30,141097,港北区,日吉本町一丁目,88,8,3,5
2016/9/30,141097,港北区,日吉本町一丁目,89,13,7,6
2016/9/30,141097,港北区,日吉本町一丁目,90,10,2,8
2016/9/30,141097,港北区,日吉本町一丁目,91,8,4,4
2016/9/30,141097,港北区,日吉本町一丁目,92,10,3,7
2016/9/30,141097,港北区,日吉本町一丁目,93,5,3,2
2016/9/30,141097,港北区,日吉本町一丁目,94,3,0,3
2016/9/30,141097,港北区,日吉本町一丁目,95,4,2,2
2016/9/30,141097,港北区,日吉本町一丁目,96,3,1,2
2016/9/30,141097,港北区,日吉本町一丁目,97,2,1,1
2016/9/30,141097,港北区,日吉本町一丁目,98,1,0,1
2016/9/30,141097,港北区,日吉本町一丁目,99,0,0,0
2016/9/30,141097,港北区,日吉本町一丁目,100,4,0,4
2016/9/30,141097,港北区,日吉本町二丁目,合計,5266,2647,2619
2016/9/30,141097,港北区,日吉本町二丁目,0,48,24,24
2016/9/30,141097,港北区,日吉本町二丁目,1,40,21,19
2016/9/30,141097,港北区,日吉本町二丁目,2,47,30,17
2016/9/30,141097,港北区,日吉本町二丁目,3,37,15,22
2016/9/30,141097,港北区,日吉本町二丁目,4,44,24,20
2016/9/30,141097,港北区,日吉本町二丁目,5,29,16,13
2016/9/30,141097,港北区,日吉本町二丁目,6,37,18,19
2016/9/30,141097,港北区,日吉本町二丁目,7,39,14,25
2016/9/30,141097,港北区,日吉本町二丁目,8,33,16,17
2016/9/30,141097,港北区,日吉本町二丁目,9,43,17,26
2016/9/30,141097,港北区,日吉本町二丁目,10,39,16,23
2016/9/30,141097,港北区,日吉本町二丁目,11,32,17,15
2016/9/30,141097,港北区,日吉本町二丁目,12,25,13,12
2016/9/30,141097,港北区,日吉本町二丁目,13,28,13,15
2016/9/30,141097,港北区,日吉本町二丁目,14,32,19,13
2016/9/30,141097,港北区,日吉本町二丁目,15,44,24,20
2016/9/30,141097,港北区,日吉本町二丁目,16,41,22,19
2016/9/30,141097,港北区,日吉本町二丁目,17,42,20,22
2016/9/30,141097,港北区,日吉本町二丁目,18,53,28,25
2016/9/30,141097,港北区,日吉本町二丁目,19,58,33,25
2016/9/30,141097,港北区,日吉本町二丁目,20,62,34,28
2016/9/30,141097,港北区,日吉本町二丁目,21,75,41,34
2016/9/30,141097,港北区,日吉本町二丁目,22,85,47,38
2016/9/30,141097,港北区,日吉本町二丁目,23,105,49,56
2016/9/30,141097,港北区,日吉本町二丁目,24,94,51,43
2016/9/30,141097,港北区,日吉本町二丁目,25,82,38,44
2016/9/30,141097,港北区,日吉本町二丁目,26,86,39,47
2016/9/30,141097,港北区,日吉本町二丁目,27,76,42,34
2016/9/30,141097,港北区,日吉本町二丁目,28,94,43,51
2016/9/30,141097,港北区,日吉本町二丁目,29,89,51,38
2016/9/30,141097,港北区,日吉本町二丁目,30,100,59,41
2016/9/30,141097,港北区,日吉本町二丁目,31,109,54,55
2016/9/30,141097,港北区,日吉本町二丁目,32,80,46,34
2016/9/30,141097,港北区,日吉本町二丁目,33,87,49,38
2016/9/30,141097,港北区,日吉本町二丁目,34,85,54,31
2016/9/30,141097,港北区,日吉本町二丁目,35,79,45,34
2016/9/30,141097,港北区,日吉本町二丁目,36,66,37,29
2016/9/30,141097,港北区,日吉本町二丁目,37,83,36,47
2016/9/30,141097,港北区,日吉本町二丁目,38,77,34,43
2016/9/30,141097,港北区,日吉本町二丁目,39,77,45,32
2016/9/30,141097,港北区,日吉本町二丁目,40,62,36,26
2016/9/30,141097,港北区,日吉本町二丁目,41,86,39,47
2016/9/30,141097,港北区,日吉本町二丁目,42,89,58,31
2016/9/30,141097,港北区,日吉本町二丁目,43,91,50,41
2016/9/30,141097,港北区,日吉本町二丁目,44,80,40,40
2016/9/30,141097,港北区,日吉本町二丁目,45,98,35,63
2016/9/30,141097,港北区,日吉本町二丁目,46,80,41,39
2016/9/30,141097,港北区,日吉本町二丁目,47,93,43,50
2016/9/30,141097,港北区,日吉本町二丁目,48,71,40,31
2016/9/30,141097,港北区,日吉本町二丁目,49,85,49,36
2016/9/30,141097,港北区,日吉本町二丁目,50,75,40,35
2016/9/30,141097,港北区,日吉本町二丁目,51,88,43,45
2016/9/30,141097,港北区,日吉本町二丁目,52,70,40,30
2016/9/30,141097,港北区,日吉本町二丁目,53,73,43,30
2016/9/30,141097,港北区,日吉本町二丁目,54,80,29,51
2016/9/30,141097,港北区,日吉本町二丁目,55,63,28,35
2016/9/30,141097,港北区,日吉本町二丁目,56,63,29,34
2016/9/30,141097,港北区,日吉本町二丁目,57,70,32,38
2016/9/30,141097,港北区,日吉本町二丁目,58,52,22,30
2016/9/30,141097,港北区,日吉本町二丁目,59,46,26,20
2016/9/30,141097,港北区,日吉本町二丁目,60,45,22,23
2016/9/30,141097,港北区,日吉本町二丁目,61,45,19,26
2016/9/30,141097,港北区,日吉本町二丁目,62,56,30,26
2016/9/30,141097,港北区,日吉本町二丁目,63,47,23,24
2016/9/30,141097,港北区,日吉本町二丁目,64,66,39,27
2016/9/30,141097,港北区,日吉本町二丁目,65,64,32,32
2016/9/30,141097,港北区,日吉本町二丁目,66,61,36,25
2016/9/30,141097,港北区,日吉本町二丁目,67,58,33,25
2016/9/30,141097,港北区,日吉本町二丁目,68,57,26,31
2016/9/30,141097,港北区,日吉本町二丁目,69,61,29,32
2016/9/30,141097,港北区,日吉本町二丁目,70,38,21,17
2016/9/30,141097,港北区,日吉本町二丁目,71,38,18,20
2016/9/30,141097,港北区,日吉本町二丁目,72,54,30,24
2016/9/30,141097,港北区,日吉本町二丁目,73,48,26,22
2016/9/30,141097,港北区,日吉本町二丁目,74,46,20,26
2016/9/30,141097,港北区,日吉本町二丁目,75,39,12,27
2016/9/30,141097,港北区,日吉本町二丁目,76,37,17,20
2016/9/30,141097,港北区,日吉本町二丁目,77,35,13,22
2016/9/30,141097,港北区,日吉本町二丁目,78,35,16,19
2016/9/30,141097,港北区,日吉本町二丁目,79,38,19,19
2016/9/30,141097,港北区,日吉本町二丁目,80,45,21,24
2016/9/30,141097,港北区,日吉本町二丁目,81,24,12,12
2016/9/30,141097,港北区,日吉本町二丁目,82,36,13,23
2016/9/30,141097,港北区,日吉本町二丁目,83,33,6,27
2016/9/30,141097,港北区,日吉本町二丁目,84,26,9,17
2016/9/30,141097,港北区,日吉本町二丁目,85,15,6,9
2016/9/30,141097,港北区,日吉本町二丁目,86,15,5,10
2016/9/30,141097,港北区,日吉本町二丁目,87,23,12,11
2016/9/30,141097,港北区,日吉本町二丁目,88,15,7,8
2016/9/30,141097,港北区,日吉本町二丁目,89,9,4,5
2016/9/30,141097,港北区,日吉本町二丁目,90,13,3,10
2016/9/30,141097,港北区,日吉本町二丁目,91,10,3,7
2016/9/30,141097,港北区,日吉本町二丁目,92,4,0,4
2016/9/30,141097,港北区,日吉本町二丁目,93,11,3,8
2016/9/30,141097,港北区,日吉本町二丁目,94,8,1,7
2016/9/30,141097,港北区,日吉本町二丁目,95,4,1,3
2016/9/30,141097,港北区,日吉本町二丁目,96,4,0,4
2016/9/30,141097,港北区,日吉本町二丁目,97,1,1,0
2016/9/30,141097,港北区,日吉本町二丁目,98,0,0,0
2016/9/30,141097,港北区,日吉本町二丁目,99,2,1,1
2016/9/30,141097,港北区,日吉本町二丁目,100,3,1,2
2016/9/30,141097,港北区,日吉本町三丁目,合計,5302,2744,2558
2016/9/30,141097,港北区,日吉本町三丁目,0,56,28,28
2016/9/30,141097,港北区,日吉本町三丁目,1,51,23,28
2016/9/30,141097,港北区,日吉本町三丁目,2,55,28,27
2016/9/30,141097,港北区,日吉本町三丁目,3,60,30,30
2016/9/30,141097,港北区,日吉本町三丁目,4,52,31,21
2016/9/30,141097,港北区,日吉本町三丁目,5,42,23,19
2016/9/30,141097,港北区,日吉本町三丁目,6,58,27,31
2016/9/30,141097,港北区,日吉本町三丁目,7,52,29,23
2016/9/30,141097,港北区,日吉本町三丁目,8,50,23,27
2016/9/30,141097,港北区,日吉本町三丁目,9,60,35,25
2016/9/30,141097,港北区,日吉本町三丁目,10,56,23,33
2016/9/30,141097,港北区,日吉本町三丁目,11,39,16,23
2016/9/30,141097,港北区,日吉本町三丁目,12,54,31,23
2016/9/30,141097,港北区,日吉本町三丁目,13,46,29,17
2016/9/30,141097,港北区,日吉本町三丁目,14,59,35,24
2016/9/30,141097,港北区,日吉本町三丁目,15,34,22,12
2016/9/30,141097,港北区,日吉本町三丁目,16,54,29,25
2016/9/30,141097,港北区,日吉本町三丁目,17,40,22,18
2016/9/30,141097,港北区,日吉本町三丁目,18,42,24,18
2016/9/30,141097,港北区,日吉本町三丁目,19,57,27,30
2016/9/30,141097,港北区,日吉本町三丁目,20,45,28,17
2016/9/30,141097,港北区,日吉本町三丁目,21,51,35,16
2016/9/30,141097,港北区,日吉本町三丁目,22,73,51,22
2016/9/30,141097,港北区,日吉本町三丁目,23,77,53,24
2016/9/30,141097,港北区,日吉本町三丁目,24,80,44,36
2016/9/30,141097,港北区,日吉本町三丁目,25,74,48,26
2016/9/30,141097,港北区,日吉本町三丁目,26,77,46,31
2016/9/30,141097,港北区,日吉本町三丁目,27,66,34,32
2016/9/30,141097,港北区,日吉本町三丁目,28,78,44,34
2016/9/30,141097,港北区,日吉本町三丁目,29,72,42,30
2016/9/30,141097,港北区,日吉本町三丁目,30,71,40,31
2016/9/30,141097,港北区,日吉本町三丁目,31,80,35,45
2016/9/30,141097,港北区,日吉本町三丁目,32,82,38,44
2016/9/30,141097,港北区,日吉本町三丁目,33,70,34,36
2016/9/30,141097,港北区,日吉本町三丁目,34,86,43,43
2016/9/30,141097,港北区,日吉本町三丁目,35,88,41,47
2016/9/30,141097,港北区,日吉本町三丁目,36,98,55,43
2016/9/30,141097,港北区,日吉本町三丁目,37,91,48,43
2016/9/30,141097,港北区,日吉本町三丁目,38,101,58,43
2016/9/30,141097,港北区,日吉本町三丁目,39,104,47,57
2016/9/30,141097,港北区,日吉本町三丁目,40,111,64,47
2016/9/30,141097,港北区,日吉本町三丁目,41,97,47,50
2016/9/30,141097,港北区,日吉本町三丁目,42,111,60,51
2016/9/30,141097,港北区,日吉本町三丁目,43,102,59,43
2016/9/30,141097,港北区,日吉本町三丁目,44,126,62,64
2016/9/30,141097,港北区,日吉本町三丁目,45,110,51,59
2016/9/30,141097,港北区,日吉本町三丁目,46,85,43,42
2016/9/30,141097,港北区,日吉本町三丁目,47,115,56,59
2016/9/30,141097,港北区,日吉本町三丁目,48,100,52,48
2016/9/30,141097,港北区,日吉本町三丁目,49,111,59,52
2016/9/30,141097,港北区,日吉本町三丁目,50,68,33,35
2016/9/30,141097,港北区,日吉本町三丁目,51,103,53,50
2016/9/30,141097,港北区,日吉本町三丁目,52,78,45,33
2016/9/30,141097,港北区,日吉本町三丁目,53,74,41,33
2016/9/30,141097,港北区,日吉本町三丁目,54,72,35,37
2016/9/30,141097,港北区,日吉本町三丁目,55,57,30,27
2016/9/30,141097,港北区,日吉本町三丁目,56,57,32,25
2016/9/30,141097,港北区,日吉本町三丁目,57,59,32,27
2016/9/30,141097,港北区,日吉本町三丁目,58,66,37,29
2016/9/30,141097,港北区,日吉本町三丁目,59,44,20,24
2016/9/30,141097,港北区,日吉本町三丁目,60,42,28,14
2016/9/30,141097,港北区,日吉本町三丁目,61,37,16,21
2016/9/30,141097,港北区,日吉本町三丁目,62,44,23,21
2016/9/30,141097,港北区,日吉本町三丁目,63,45,24,21
2016/9/30,141097,港北区,日吉本町三丁目,64,45,18,27
2016/9/30,141097,港北区,日吉本町三丁目,65,49,23,26
2016/9/30,141097,港北区,日吉本町三丁目,66,49,26,23
2016/9/30,141097,港北区,日吉本町三丁目,67,58,26,32
2016/9/30,141097,港北区,日吉本町三丁目,68,52,23,29
2016/9/30,141097,港北区,日吉本町三丁目,69,45,14,31
2016/9/30,141097,港北区,日吉本町三丁目,70,28,18,10
2016/9/30,141097,港北区,日吉本町三丁目,71,26,12,14
2016/9/30,141097,港北区,日吉本町三丁目,72,47,25,22
2016/9/30,141097,港北区,日吉本町三丁目,73,37,18,19
2016/9/30,141097,港北区,日吉本町三丁目,74,29,17,12
2016/9/30,141097,港北区,日吉本町三丁目,75,34,11,23
2016/9/30,141097,港北区,日吉本町三丁目,76,31,16,15
2016/9/30,141097,港北区,日吉本町三丁目,77,23,9,14
2016/9/30,141097,港北区,日吉本町三丁目,78,23,7,16
2016/9/30,141097,港北区,日吉本町三丁目,79,15,7,8
2016/9/30,141097,港北区,日吉本町三丁目,80,24,8,16
2016/9/30,141097,港北区,日吉本町三丁目,81,26,12,14
2016/9/30,141097,港北区,日吉本町三丁目,82,19,7,12
2016/9/30,141097,港北区,日吉本町三丁目,83,18,8,10
2016/9/30,141097,港北区,日吉本町三丁目,84,15,7,8
2016/9/30,141097,港北区,日吉本町三丁目,85,27,9,18
2016/9/30,141097,港北区,日吉本町三丁目,86,17,3,14
2016/9/30,141097,港北区,日吉本町三丁目,87,8,0,8
2016/9/30,141097,港北区,日吉本町三丁目,88,18,7,11
2016/9/30,141097,港北区,日吉本町三丁目,89,11,4,7
2016/9/30,141097,港北区,日吉本町三丁目,90,8,2,6
2016/9/30,141097,港北区,日吉本町三丁目,91,5,2,3
2016/9/30,141097,港北区,日吉本町三丁目,92,5,2,3
2016/9/30,141097,港北区,日吉本町三丁目,93,1,0,1
2016/9/30,141097,港北区,日吉本町三丁目,94,3,0,3
2016/9/30,141097,港北区,日吉本町三丁目,95,4,0,4
2016/9/30,141097,港北区,日吉本町三丁目,96,2,1,1
2016/9/30,141097,港北区,日吉本町三丁目,97,1,1,0
2016/9/30,141097,港北区,日吉本町三丁目,98,2,0,2
2016/9/30,141097,港北区,日吉本町三丁目,99,1,0,1
2016/9/30,141097,港北区,日吉本町三丁目,100,1,0,1
2016/9/30,141097,港北区,日吉本町四丁目,合計,7684,3759,3925
2016/9/30,141097,港北区,日吉本町四丁目,0,88,46,42
2016/9/30,141097,港北区,日吉本町四丁目,1,100,52,48
2016/9/30,141097,港北区,日吉本町四丁目,2,73,47,26
2016/9/30,141097,港北区,日吉本町四丁目,3,92,44,48
2016/9/30,141097,港北区,日吉本町四丁目,4,115,53,62
2016/9/30,141097,港北区,日吉本町四丁目,5,81,48,33
2016/9/30,141097,港北区,日吉本町四丁目,6,108,58,50
2016/9/30,141097,港北区,日吉本町四丁目,7,79,40,39
2016/9/30,141097,港北区,日吉本町四丁目,8,103,57,46
2016/9/30,141097,港北区,日吉本町四丁目,9,98,50,48
2016/9/30,141097,港北区,日吉本町四丁目,10,85,41,44
2016/9/30,141097,港北区,日吉本町四丁目,11,94,51,43
2016/9/30,141097,港北区,日吉本町四丁目,12,82,46,36
2016/9/30,141097,港北区,日吉本町四丁目,13,88,41,47
2016/9/30,141097,港北区,日吉本町四丁目,14,78,47,31
2016/9/30,141097,港北区,日吉本町四丁目,15,70,40,30
2016/9/30,141097,港北区,日吉本町四丁目,16,67,31,36
2016/9/30,141097,港北区,日吉本町四丁目,17,67,38,29
2016/9/30,141097,港北区,日吉本町四丁目,18,54,25,29
2016/9/30,141097,港北区,日吉本町四丁目,19,59,33,26
2016/9/30,141097,港北区,日吉本町四丁目,20,51,27,24
2016/9/30,141097,港北区,日吉本町四丁目,21,45,27,18
2016/9/30,141097,港北区,日吉本町四丁目,22,59,29,30
2016/9/30,141097,港北区,日吉本町四丁目,23,53,26,27
2016/9/30,141097,港北区,日吉本町四丁目,24,49,28,21
2016/9/30,141097,港北区,日吉本町四丁目,25,63,34,29
2016/9/30,141097,港北区,日吉本町四丁目,26,57,27,30
2016/9/30,141097,港北区,日吉本町四丁目,27,71,32,39
2016/9/30,141097,港北区,日吉本町四丁目,28,78,32,46
2016/9/30,141097,港北区,日吉本町四丁目,29,94,54,40
2016/9/30,141097,港北区,日吉本町四丁目,30,97,43,54
2016/9/30,141097,港北区,日吉本町四丁目,31,93,46,47
2016/9/30,141097,港北区,日吉本町四丁目,32,107,60,47
2016/9/30,141097,港北区,日吉本町四丁目,33,116,52,64
2016/9/30,141097,港北区,日吉本町四丁目,34,121,53,68
2016/9/30,141097,港北区,日吉本町四丁目,35,120,67,53
2016/9/30,141097,港北区,日吉本町四丁目,36,131,69,62
2016/9/30,141097,港北区,日吉本町四丁目,37,143,75,68
2016/9/30,141097,港北区,日吉本町四丁目,38,134,58,76
2016/9/30,141097,港北区,日吉本町四丁目,39,169,80,89
2016/9/30,141097,港北区,日吉本町四丁目,40,177,74,103
2016/9/30,141097,港北区,日吉本町四丁目,41,177,81,96
2016/9/30,141097,港北区,日吉本町四丁目,42,198,94,104
2016/9/30,141097,港北区,日吉本町四丁目,43,188,99,89
2016/9/30,141097,港北区,日吉本町四丁目,44,172,84,88
2016/9/30,141097,港北区,日吉本町四丁目,45,164,72,92
2016/9/30,141097,港北区,日吉本町四丁目,46,169,92,77
2016/9/30,141097,港北区,日吉本町四丁目,47,162,77,85
2016/9/30,141097,港北区,日吉本町四丁目,48,151,85,66
2016/9/30,141097,港北区,日吉本町四丁目,49,124,62,62
2016/9/30,141097,港北区,日吉本町四丁目,50,86,52,34
2016/9/30,141097,港北区,日吉本町四丁目,51,111,60,51
2016/9/30,141097,港北区,日吉本町四丁目,52,117,65,52
2016/9/30,141097,港北区,日吉本町四丁目,53,100,59,41
2016/9/30,141097,港北区,日吉本町四丁目,54,91,53,38
2016/9/30,141097,港北区,日吉本町四丁目,55,74,36,38
2016/9/30,141097,港北区,日吉本町四丁目,56,58,31,27
2016/9/30,141097,港北区,日吉本町四丁目,57,62,26,36
2016/9/30,141097,港北区,日吉本町四丁目,58,45,17,28
2016/9/30,141097,港北区,日吉本町四丁目,59,63,29,34
2016/9/30,141097,港北区,日吉本町四丁目,60,58,24,34
2016/9/30,141097,港北区,日吉本町四丁目,61,60,28,32
2016/9/30,141097,港北区,日吉本町四丁目,62,41,21,20
2016/9/30,141097,港北区,日吉本町四丁目,63,59,27,32
2016/9/30,141097,港北区,日吉本町四丁目,64,70,35,35
2016/9/30,141097,港北区,日吉本町四丁目,65,64,35,29
2016/9/30,141097,港北区,日吉本町四丁目,66,75,39,36
2016/9/30,141097,港北区,日吉本町四丁目,67,85,39,46
2016/9/30,141097,港北区,日吉本町四丁目,68,76,36,40
2016/9/30,141097,港北区,日吉本町四丁目,69,57,30,27
2016/9/30,141097,港北区,日吉本町四丁目,70,44,23,21
2016/9/30,141097,港北区,日吉本町四丁目,71,54,28,26
2016/9/30,141097,港北区,日吉本町四丁目,72,56,18,38
2016/9/30,141097,港北区,日吉本町四丁目,73,60,24,36
2016/9/30,141097,港北区,日吉本町四丁目,74,49,18,31
2016/9/30,141097,港北区,日吉本町四丁目,75,53,22,31
2016/9/30,141097,港北区,日吉本町四丁目,76,53,20,33
2016/9/30,141097,港北区,日吉本町四丁目,77,37,22,15
2016/9/30,141097,港北区,日吉本町四丁目,78,58,15,43
2016/9/30,141097,港北区,日吉本町四丁目,79,68,20,48
2016/9/30,141097,港北区,日吉本町四丁目,80,65,25,40
2016/9/30,141097,港北区,日吉本町四丁目,81,62,21,41
2016/9/30,141097,港北区,日吉本町四丁目,82,56,25,31
2016/9/30,141097,港北区,日吉本町四丁目,83,35,15,20
2016/9/30,141097,港北区,日吉本町四丁目,84,36,21,15
2016/9/30,141097,港北区,日吉本町四丁目,85,45,14,31
2016/9/30,141097,港北区,日吉本町四丁目,86,31,12,19
2016/9/30,141097,港北区,日吉本町四丁目,87,29,9,20
2016/9/30,141097,港北区,日吉本町四丁目,88,26,8,18
2016/9/30,141097,港北区,日吉本町四丁目,89,29,11,18
2016/9/30,141097,港北区,日吉本町四丁目,90,17,5,12
2016/9/30,141097,港北区,日吉本町四丁目,91,13,2,11
2016/9/30,141097,港北区,日吉本町四丁目,92,9,4,5
2016/9/30,141097,港北区,日吉本町四丁目,93,7,1,6
2016/9/30,141097,港北区,日吉本町四丁目,94,9,2,7
2016/9/30,141097,港北区,日吉本町四丁目,95,5,3,2
2016/9/30,141097,港北区,日吉本町四丁目,96,5,1,4
2016/9/30,141097,港北区,日吉本町四丁目,97,3,1,2
2016/9/30,141097,港北区,日吉本町四丁目,98,0,0,0
2016/9/30,141097,港北区,日吉本町四丁目,99,1,0,1
2016/9/30,141097,港北区,日吉本町四丁目,100,3,0,3
2016/9/30,141097,港北区,日吉本町五丁目,合計,2813,1414,1399
2016/9/30,141097,港北区,日吉本町五丁目,0,31,17,14
2016/9/30,141097,港北区,日吉本町五丁目,1,17,10,7
2016/9/30,141097,港北区,日吉本町五丁目,2,14,10,4
2016/9/30,141097,港北区,日吉本町五丁目,3,13,7,6
2016/9/30,141097,港北区,日吉本町五丁目,4,24,18,6
2016/9/30,141097,港北区,日吉本町五丁目,5,20,10,10
2016/9/30,141097,港北区,日吉本町五丁目,6,14,7,7
2016/9/30,141097,港北区,日吉本町五丁目,7,25,10,15
2016/9/30,141097,港北区,日吉本町五丁目,8,19,9,10
2016/9/30,141097,港北区,日吉本町五丁目,9,27,13,14
2016/9/30,141097,港北区,日吉本町五丁目,10,21,12,9
2016/9/30,141097,港北区,日吉本町五丁目,11,22,13,9
2016/9/30,141097,港北区,日吉本町五丁目,12,19,11,8
2016/9/30,141097,港北区,日吉本町五丁目,13,22,13,9
2016/9/30,141097,港北区,日吉本町五丁目,14,29,13,16
2016/9/30,141097,港北区,日吉本町五丁目,15,23,13,10
2016/9/30,141097,港北区,日吉本町五丁目,16,29,16,13
2016/9/30,141097,港北区,日吉本町五丁目,17,20,11,9
2016/9/30,141097,港北区,日吉本町五丁目,18,36,20,16
2016/9/30,141097,港北区,日吉本町五丁目,19,20,10,10
2016/9/30,141097,港北区,日吉本町五丁目,20,29,14,15
2016/9/30,141097,港北区,日吉本町五丁目,21,41,19,22
2016/9/30,141097,港北区,日吉本町五丁目,22,32,15,17
2016/9/30,141097,港北区,日吉本町五丁目,23,31,16,15
2016/9/30,141097,港北区,日吉本町五丁目,24,26,12,14
2016/9/30,141097,港北区,日吉本町五丁目,25,41,21,20
2016/9/30,141097,港北区,日吉本町五丁目,26,29,15,14
2016/9/30,141097,港北区,日吉本町五丁目,27,34,20,14
2016/9/30,141097,港北区,日吉本町五丁目,28,35,18,17
2016/9/30,141097,港北区,日吉本町五丁目,29,38,19,19
2016/9/30,141097,港北区,日吉本町五丁目,30,34,17,17
2016/9/30,141097,港北区,日吉本町五丁目,31,43,29,14
2016/9/30,141097,港北区,日吉本町五丁目,32,39,26,13
2016/9/30,141097,港北区,日吉本町五丁目,33,33,16,17
2016/9/30,141097,港北区,日吉本町五丁目,34,37,17,20
2016/9/30,141097,港北区,日吉本町五丁目,35,33,16,17
2016/9/30,141097,港北区,日吉本町五丁目,36,46,21,25
2016/9/30,141097,港北区,日吉本町五丁目,37,41,21,20
2016/9/30,141097,港北区,日吉本町五丁目,38,38,20,18
2016/9/30,141097,港北区,日吉本町五丁目,39,44,22,22
2016/9/30,141097,港北区,日吉本町五丁目,40,53,30,23
2016/9/30,141097,港北区,日吉本町五丁目,41,47,28,19
2016/9/30,141097,港北区,日吉本町五丁目,42,42,22,20
2016/9/30,141097,港北区,日吉本町五丁目,43,27,12,15
2016/9/30,141097,港北区,日吉本町五丁目,44,42,27,15
2016/9/30,141097,港北区,日吉本町五丁目,45,40,23,17
2016/9/30,141097,港北区,日吉本町五丁目,46,37,18,19
2016/9/30,141097,港北区,日吉本町五丁目,47,41,19,22
2016/9/30,141097,港北区,日吉本町五丁目,48,50,20,30
2016/9/30,141097,港北区,日吉本町五丁目,49,42,21,21
2016/9/30,141097,港北区,日吉本町五丁目,50,48,22,26
2016/9/30,141097,港北区,日吉本町五丁目,51,40,24,16
2016/9/30,141097,港北区,日吉本町五丁目,52,56,29,27
2016/9/30,141097,港北区,日吉本町五丁目,53,44,20,24
2016/9/30,141097,港北区,日吉本町五丁目,54,49,21,28
2016/9/30,141097,港北区,日吉本町五丁目,55,37,18,19
2016/9/30,141097,港北区,日吉本町五丁目,56,29,20,9
2016/9/30,141097,港北区,日吉本町五丁目,57,29,10,19
2016/9/30,141097,港北区,日吉本町五丁目,58,23,11,12
2016/9/30,141097,港北区,日吉本町五丁目,59,33,21,12
2016/9/30,141097,港北区,日吉本町五丁目,60,29,16,13
2016/9/30,141097,港北区,日吉本町五丁目,61,30,16,14
2016/9/30,141097,港北区,日吉本町五丁目,62,24,10,14
2016/9/30,141097,港北区,日吉本町五丁目,63,20,10,10
2016/9/30,141097,港北区,日吉本町五丁目,64,22,10,12
2016/9/30,141097,港北区,日吉本町五丁目,65,26,14,12
2016/9/30,141097,港北区,日吉本町五丁目,66,52,20,32
2016/9/30,141097,港北区,日吉本町五丁目,67,35,19,16
2016/9/30,141097,港北区,日吉本町五丁目,68,35,15,20
2016/9/30,141097,港北区,日吉本町五丁目,69,50,22,28
2016/9/30,141097,港北区,日吉本町五丁目,70,25,14,11
2016/9/30,141097,港北区,日吉本町五丁目,71,25,6,19
2016/9/30,141097,港北区,日吉本町五丁目,72,28,14,14
2016/9/30,141097,港北区,日吉本町五丁目,73,40,19,21
2016/9/30,141097,港北区,日吉本町五丁目,74,44,23,21
2016/9/30,141097,港北区,日吉本町五丁目,75,34,12,22
2016/9/30,141097,港北区,日吉本町五丁目,76,37,19,18
2016/9/30,141097,港北区,日吉本町五丁目,77,26,11,15
2016/9/30,141097,港北区,日吉本町五丁目,78,17,11,6
2016/9/30,141097,港北区,日吉本町五丁目,79,24,9,15
2016/9/30,141097,港北区,日吉本町五丁目,80,23,11,12
2016/9/30,141097,港北区,日吉本町五丁目,81,28,12,16
2016/9/30,141097,港北区,日吉本町五丁目,82,24,16,8
2016/9/30,141097,港北区,日吉本町五丁目,83,35,16,19
2016/9/30,141097,港北区,日吉本町五丁目,84,17,6,11
2016/9/30,141097,港北区,日吉本町五丁目,85,17,5,12
2016/9/30,141097,港北区,日吉本町五丁目,86,13,8,5
2016/9/30,141097,港北区,日吉本町五丁目,87,8,6,2
2016/9/30,141097,港北区,日吉本町五丁目,88,10,2,8
2016/9/30,141097,港北区,日吉本町五丁目,89,4,2,2
2016/9/30,141097,港北区,日吉本町五丁目,90,8,1,7
2016/9/30,141097,港北区,日吉本町五丁目,91,7,4,3
2016/9/30,141097,港北区,日吉本町五丁目,92,4,0,4
2016/9/30,141097,港北区,日吉本町五丁目,93,6,2,4
2016/9/30,141097,港北区,日吉本町五丁目,94,2,0,2
2016/9/30,141097,港北区,日吉本町五丁目,95,2,0,2
2016/9/30,141097,港北区,日吉本町五丁目,96,1,0,1
2016/9/30,141097,港北区,日吉本町五丁目,97,0,0,0
2016/9/30,141097,港北区,日吉本町五丁目,98,1,0,1
2016/9/30,141097,港北区,日吉本町五丁目,99,0,0,0
2016/9/30,141097,港北区,日吉本町五丁目,100,2,0,2
2016/9/30,141097,港北区,日吉本町六丁目,合計,3275,1620,1655
2016/9/30,141097,港北区,日吉本町六丁目,0,33,16,17
2016/9/30,141097,港北区,日吉本町六丁目,1,23,8,15
2016/9/30,141097,港北区,日吉本町六丁目,2,35,24,11
2016/9/30,141097,港北区,日吉本町六丁目,3,26,14,12
2016/9/30,141097,港北区,日吉本町六丁目,4,22,13,9
2016/9/30,141097,港北区,日吉本町六丁目,5,32,18,14
2016/9/30,141097,港北区,日吉本町六丁目,6,31,18,13
2016/9/30,141097,港北区,日吉本町六丁目,7,26,13,13
2016/9/30,141097,港北区,日吉本町六丁目,8,33,13,20
2016/9/30,141097,港北区,日吉本町六丁目,9,32,13,19
2016/9/30,141097,港北区,日吉本町六丁目,10,27,8,19
2016/9/30,141097,港北区,日吉本町六丁目,11,30,16,14
2016/9/30,141097,港北区,日吉本町六丁目,12,24,10,14
2016/9/30,141097,港北区,日吉本町六丁目,13,29,11,18
2016/9/30,141097,港北区,日吉本町六丁目,14,27,10,17
2016/9/30,141097,港北区,日吉本町六丁目,15,26,11,15
2016/9/30,141097,港北区,日吉本町六丁目,16,30,13,17
2016/9/30,141097,港北区,日吉本町六丁目,17,26,14,12
2016/9/30,141097,港北区,日吉本町六丁目,18,30,10,20
2016/9/30,141097,港北区,日吉本町六丁目,19,31,14,17
2016/9/30,141097,港北区,日吉本町六丁目,20,33,16,17
2016/9/30,141097,港北区,日吉本町六丁目,21,40,25,15
2016/9/30,141097,港北区,日吉本町六丁目,22,29,14,15
2016/9/30,141097,港北区,日吉本町六丁目,23,37,17,20
2016/9/30,141097,港北区,日吉本町六丁目,24,45,18,27
2016/9/30,141097,港北区,日吉本町六丁目,25,37,20,17
2016/9/30,141097,港北区,日吉本町六丁目,26,31,14,17
2016/9/30,141097,港北区,日吉本町六丁目,27,45,26,19
2016/9/30,141097,港北区,日吉本町六丁目,28,31,20,11
2016/9/30,141097,港北区,日吉本町六丁目,29,44,22,22
2016/9/30,141097,港北区,日吉本町六丁目,30,39,16,23
2016/9/30,141097,港北区,日吉本町六丁目,31,49,23,26
2016/9/30,141097,港北区,日吉本町六丁目,32,49,28,21
2016/9/30,141097,港北区,日吉本町六丁目,33,34,22,12
2016/9/30,141097,港北区,日吉本町六丁目,34,42,22,20
2016/9/30,141097,港北区,日吉本町六丁目,35,35,20,15
2016/9/30,141097,港北区,日吉本町六丁目,36,35,21,14
2016/9/30,141097,港北区,日吉本町六丁目,37,46,28,18
2016/9/30,141097,港北区,日吉本町六丁目,38,31,16,15
2016/9/30,141097,港北区,日吉本町六丁目,39,73,26,47
2016/9/30,141097,港北区,日吉本町六丁目,40,45,25,20
2016/9/30,141097,港北区,日吉本町六丁目,41,63,35,28
2016/9/30,141097,港北区,日吉本町六丁目,42,55,25,30
2016/9/30,141097,港北区,日吉本町六丁目,43,69,35,34
2016/9/30,141097,港北区,日吉本町六丁目,44,52,18,34
2016/9/30,141097,港北区,日吉本町六丁目,45,62,37,25
2016/9/30,141097,港北区,日吉本町六丁目,46,53,29,24
2016/9/30,141097,港北区,日吉本町六丁目,47,56,30,26
2016/9/30,141097,港北区,日吉本町六丁目,48,58,30,28
2016/9/30,141097,港北区,日吉本町六丁目,49,51,23,28
2016/9/30,141097,港北区,日吉本町六丁目,50,49,30,19
2016/9/30,141097,港北区,日吉本町六丁目,51,49,28,21
2016/9/30,141097,港北区,日吉本町六丁目,52,42,22,20
2016/9/30,141097,港北区,日吉本町六丁目,53,67,36,31
2016/9/30,141097,港北区,日吉本町六丁目,54,36,20,16
2016/9/30,141097,港北区,日吉本町六丁目,55,46,20,26
2016/9/30,141097,港北区,日吉本町六丁目,56,40,16,24
2016/9/30,141097,港北区,日吉本町六丁目,57,31,15,16
2016/9/30,141097,港北区,日吉本町六丁目,58,33,16,17
2016/9/30,141097,港北区,日吉本町六丁目,59,30,17,13
2016/9/30,141097,港北区,日吉本町六丁目,60,30,18,12
2016/9/30,141097,港北区,日吉本町六丁目,61,35,23,12
2016/9/30,141097,港北区,日吉本町六丁目,62,42,27,15
2016/9/30,141097,港北区,日吉本町六丁目,63,42,21,21
2016/9/30,141097,港北区,日吉本町六丁目,64,46,25,21
2016/9/30,141097,港北区,日吉本町六丁目,65,38,19,19
2016/9/30,141097,港北区,日吉本町六丁目,66,36,18,18
2016/9/30,141097,港北区,日吉本町六丁目,67,42,21,21
2016/9/30,141097,港北区,日吉本町六丁目,68,34,19,15
2016/9/30,141097,港北区,日吉本町六丁目,69,41,17,24
2016/9/30,141097,港北区,日吉本町六丁目,70,32,10,22
2016/9/30,141097,港北区,日吉本町六丁目,71,36,16,20
2016/9/30,141097,港北区,日吉本町六丁目,72,32,11,21
2016/9/30,141097,港北区,日吉本町六丁目,73,37,17,20
2016/9/30,141097,港北区,日吉本町六丁目,74,33,13,20
2016/9/30,141097,港北区,日吉本町六丁目,75,42,15,27
2016/9/30,141097,港北区,日吉本町六丁目,76,34,17,17
2016/9/30,141097,港北区,日吉本町六丁目,77,39,17,22
2016/9/30,141097,港北区,日吉本町六丁目,78,34,16,18
2016/9/30,141097,港北区,日吉本町六丁目,79,26,12,14
2016/9/30,141097,港北区,日吉本町六丁目,80,22,13,9
2016/9/30,141097,港北区,日吉本町六丁目,81,17,6,11
2016/9/30,141097,港北区,日吉本町六丁目,82,24,15,9
2016/9/30,141097,港北区,日吉本町六丁目,83,17,8,9
2016/9/30,141097,港北区,日吉本町六丁目,84,14,10,4
2016/9/30,141097,港北区,日吉本町六丁目,85,18,7,11
2016/9/30,141097,港北区,日吉本町六丁目,86,11,5,6
2016/9/30,141097,港北区,日吉本町六丁目,87,10,3,7
2016/9/30,141097,港北区,日吉本町六丁目,88,11,1,10
2016/9/30,141097,港北区,日吉本町六丁目,89,4,1,3
2016/9/30,141097,港北区,日吉本町六丁目,90,5,3,2
2016/9/30,141097,港北区,日吉本町六丁目,91,8,4,4
2016/9/30,141097,港北区,日吉本町六丁目,92,3,1,2
2016/9/30,141097,港北区,日吉本町六丁目,93,4,2,2
2016/9/30,141097,港北区,日吉本町六丁目,94,2,0,2
2016/9/30,141097,港北区,日吉本町六丁目,95,2,0,2
2016/9/30,141097,港北区,日吉本町六丁目,96,1,0,1
2016/9/30,141097,港北区,日吉本町六丁目,97,0,0,0
2016/9/30,141097,港北区,日吉本町六丁目,98,2,0,2
2016/9/30,141097,港北区,日吉本町六丁目,99,0,0,0
2016/9/30,141097,港北区,日吉本町六丁目,100,4,1,3
2016/9/30,141097,港北区,下田町一丁目,合計,1260,609,651
2016/9/30,141097,港北区,下田町一丁目,0,6,3,3
2016/9/30,141097,港北区,下田町一丁目,1,4,1,3
2016/9/30,141097,港北区,下田町一丁目,2,9,5,4
2016/9/30,141097,港北区,下田町一丁目,3,7,4,3
2016/9/30,141097,港北区,下田町一丁目,4,9,4,5
2016/9/30,141097,港北区,下田町一丁目,5,13,7,6
2016/9/30,141097,港北区,下田町一丁目,6,10,4,6
2016/9/30,141097,港北区,下田町一丁目,7,12,6,6
2016/9/30,141097,港北区,下田町一丁目,8,9,5,4
2016/9/30,141097,港北区,下田町一丁目,9,7,3,4
2016/9/30,141097,港北区,下田町一丁目,10,15,8,7
2016/9/30,141097,港北区,下田町一丁目,11,9,4,5
2016/9/30,141097,港北区,下田町一丁目,12,13,6,7
2016/9/30,141097,港北区,下田町一丁目,13,8,4,4
2016/9/30,141097,港北区,下田町一丁目,14,7,3,4
2016/9/30,141097,港北区,下田町一丁目,15,13,6,7
2016/9/30,141097,港北区,下田町一丁目,16,5,3,2
2016/9/30,141097,港北区,下田町一丁目,17,12,3,9
2016/9/30,141097,港北区,下田町一丁目,18,10,7,3
2016/9/30,141097,港北区,下田町一丁目,19,12,8,4
2016/9/30,141097,港北区,下田町一丁目,20,20,12,8
2016/9/30,141097,港北区,下田町一丁目,21,19,12,7
2016/9/30,141097,港北区,下田町一丁目,22,12,7,5
2016/9/30,141097,港北区,下田町一丁目,23,16,8,8
2016/9/30,141097,港北区,下田町一丁目,24,11,4,7
2016/9/30,141097,港北区,下田町一丁目,25,15,11,4
2016/9/30,141097,港北区,下田町一丁目,26,12,7,5
2016/9/30,141097,港北区,下田町一丁目,27,10,2,8
2016/9/30,141097,港北区,下田町一丁目,28,7,3,4
2016/9/30,141097,港北区,下田町一丁目,29,14,9,5
2016/9/30,141097,港北区,下田町一丁目,30,10,3,7
2016/9/30,141097,港北区,下田町一丁目,31,10,6,4
2016/9/30,141097,港北区,下田町一丁目,32,18,14,4
2016/9/30,141097,港北区,下田町一丁目,33,9,2,7
2016/9/30,141097,港北区,下田町一丁目,34,15,11,4
2016/9/30,141097,港北区,下田町一丁目,35,17,10,7
2016/9/30,141097,港北区,下田町一丁目,36,22,10,12
2016/9/30,141097,港北区,下田町一丁目,37,11,5,6
2016/9/30,141097,港北区,下田町一丁目,38,16,7,9
2016/9/30,141097,港北区,下田町一丁目,39,15,10,5
2016/9/30,141097,港北区,下田町一丁目,40,29,12,17
2016/9/30,141097,港北区,下田町一丁目,41,20,8,12
2016/9/30,141097,港北区,下田町一丁目,42,15,7,8
2016/9/30,141097,港北区,下田町一丁目,43,18,8,10
2016/9/30,141097,港北区,下田町一丁目,44,23,10,13
2016/9/30,141097,港北区,下田町一丁目,45,18,8,10
2016/9/30,141097,港北区,下田町一丁目,46,18,9,9
2016/9/30,141097,港北区,下田町一丁目,47,20,12,8
2016/9/30,141097,港北区,下田町一丁目,48,27,16,11
2016/9/30,141097,港北区,下田町一丁目,49,8,3,5
2016/9/30,141097,港北区,下田町一丁目,50,20,9,11
2016/9/30,141097,港北区,下田町一丁目,51,19,9,10
2016/9/30,141097,港北区,下田町一丁目,52,21,10,11
2016/9/30,141097,港北区,下田町一丁目,53,21,11,10
2016/9/30,141097,港北区,下田町一丁目,54,11,7,4
2016/9/30,141097,港北区,下田町一丁目,55,13,8,5
2016/9/30,141097,港北区,下田町一丁目,56,19,12,7
2016/9/30,141097,港北区,下田町一丁目,57,15,8,7
2016/9/30,141097,港北区,下田町一丁目,58,16,7,9
2016/9/30,141097,港北区,下田町一丁目,59,17,11,6
2016/9/30,141097,港北区,下田町一丁目,60,19,8,11
2016/9/30,141097,港北区,下田町一丁目,61,10,5,5
2016/9/30,141097,港北区,下田町一丁目,62,10,4,6
2016/9/30,141097,港北区,下田町一丁目,63,14,6,8
2016/9/30,141097,港北区,下田町一丁目,64,17,7,10
2016/9/30,141097,港北区,下田町一丁目,65,14,9,5
2016/9/30,141097,港北区,下田町一丁目,66,13,7,6
2016/9/30,141097,港北区,下田町一丁目,67,25,10,15
2016/9/30,141097,港北区,下田町一丁目,68,21,13,8
2016/9/30,141097,港北区,下田町一丁目,69,12,9,3
2016/9/30,141097,港北区,下田町一丁目,70,11,3,8
2016/9/30,141097,港北区,下田町一丁目,71,10,5,5
2016/9/30,141097,港北区,下田町一丁目,72,7,2,5
2016/9/30,141097,港北区,下田町一丁目,73,20,9,11
2016/9/30,141097,港北区,下田町一丁目,74,9,1,8
2016/9/30,141097,港北区,下田町一丁目,75,12,5,7
2016/9/30,141097,港北区,下田町一丁目,76,11,4,7
2016/9/30,141097,港北区,下田町一丁目,77,18,8,10
2016/9/30,141097,港北区,下田町一丁目,78,17,5,12
2016/9/30,141097,港北区,下田町一丁目,79,14,8,6
2016/9/30,141097,港北区,下田町一丁目,80,17,10,7
2016/9/30,141097,港北区,下田町一丁目,81,11,1,10
2016/9/30,141097,港北区,下田町一丁目,82,15,7,8
2016/9/30,141097,港北区,下田町一丁目,83,16,4,12
2016/9/30,141097,港北区,下田町一丁目,84,6,3,3
2016/9/30,141097,港北区,下田町一丁目,85,14,5,9
2016/9/30,141097,港北区,下田町一丁目,86,9,1,8
2016/9/30,141097,港北区,下田町一丁目,87,9,3,6
2016/9/30,141097,港北区,下田町一丁目,88,13,7,6
2016/9/30,141097,港北区,下田町一丁目,89,3,1,2
2016/9/30,141097,港北区,下田町一丁目,90,5,1,4
2016/9/30,141097,港北区,下田町一丁目,91,4,1,3
2016/9/30,141097,港北区,下田町一丁目,92,3,1,2
2016/9/30,141097,港北区,下田町一丁目,93,6,3,3
2016/9/30,141097,港北区,下田町一丁目,94,4,0,4
2016/9/30,141097,港北区,下田町一丁目,95,1,0,1
2016/9/30,141097,港北区,下田町一丁目,96,2,1,1
2016/9/30,141097,港北区,下田町一丁目,97,0,0,0
2016/9/30,141097,港北区,下田町一丁目,98,0,0,0
2016/9/30,141097,港北区,下田町一丁目,99,1,0,1
2016/9/30,141097,港北区,下田町一丁目,100,0,0,0
2016/9/30,141097,港北区,下田町二丁目,合計,1431,706,725
2016/9/30,141097,港北区,下田町二丁目,0,9,6,3
2016/9/30,141097,港北区,下田町二丁目,1,9,4,5
2016/9/30,141097,港北区,下田町二丁目,2,10,2,8
2016/9/30,141097,港北区,下田町二丁目,3,4,1,3
2016/9/30,141097,港北区,下田町二丁目,4,5,1,4
2016/9/30,141097,港北区,下田町二丁目,5,8,5,3
2016/9/30,141097,港北区,下田町二丁目,6,6,4,2
2016/9/30,141097,港北区,下田町二丁目,7,6,2,4
2016/9/30,141097,港北区,下田町二丁目,8,4,2,2
2016/9/30,141097,港北区,下田町二丁目,9,5,3,2
2016/9/30,141097,港北区,下田町二丁目,10,8,4,4
2016/9/30,141097,港北区,下田町二丁目,11,4,4,0
2016/9/30,141097,港北区,下田町二丁目,12,6,4,2
2016/9/30,141097,港北区,下田町二丁目,13,5,2,3
2016/9/30,141097,港北区,下田町二丁目,14,7,3,4
2016/9/30,141097,港北区,下田町二丁目,15,11,5,6
2016/9/30,141097,港北区,下田町二丁目,16,7,2,5
2016/9/30,141097,港北区,下田町二丁目,17,12,9,3
2016/9/30,141097,港北区,下田町二丁目,18,14,8,6
2016/9/30,141097,港北区,下田町二丁目,19,16,10,6
2016/9/30,141097,港北区,下田町二丁目,20,15,8,7
2016/9/30,141097,港北区,下田町二丁目,21,17,14,3
2016/9/30,141097,港北区,下田町二丁目,22,30,14,16
2016/9/30,141097,港北区,下田町二丁目,23,22,8,14
2016/9/30,141097,港北区,下田町二丁目,24,21,11,10
2016/9/30,141097,港北区,下田町二丁目,25,17,7,10
2016/9/30,141097,港北区,下田町二丁目,26,18,5,13
2016/9/30,141097,港北区,下田町二丁目,27,25,12,13
2016/9/30,141097,港北区,下田町二丁目,28,19,7,12
2016/9/30,141097,港北区,下田町二丁目,29,22,15,7
2016/9/30,141097,港北区,下田町二丁目,30,26,8,18
2016/9/30,141097,港北区,下田町二丁目,31,22,9,13
2016/9/30,141097,港北区,下田町二丁目,32,19,12,7
2016/9/30,141097,港北区,下田町二丁目,33,25,19,6
2016/9/30,141097,港北区,下田町二丁目,34,20,17,3
2016/9/30,141097,港北区,下田町二丁目,35,23,16,7
2016/9/30,141097,港北区,下田町二丁目,36,21,10,11
2016/9/30,141097,港北区,下田町二丁目,37,16,7,9
2016/9/30,141097,港北区,下田町二丁目,38,18,8,10
2016/9/30,141097,港北区,下田町二丁目,39,17,10,7
2016/9/30,141097,港北区,下田町二丁目,40,12,4,8
2016/9/30,141097,港北区,下田町二丁目,41,19,13,6
2016/9/30,141097,港北区,下田町二丁目,42,22,14,8
2016/9/30,141097,港北区,下田町二丁目,43,19,10,9
2016/9/30,141097,港北区,下田町二丁目,44,7,2,5
2016/9/30,141097,港北区,下田町二丁目,45,18,5,13
2016/9/30,141097,港北区,下田町二丁目,46,16,8,8
2016/9/30,141097,港北区,下田町二丁目,47,29,13,16
2016/9/30,141097,港北区,下田町二丁目,48,23,10,13
2016/9/30,141097,港北区,下田町二丁目,49,19,12,7
2016/9/30,141097,港北区,下田町二丁目,50,18,10,8
2016/9/30,141097,港北区,下田町二丁目,51,21,11,10
2016/9/30,141097,港北区,下田町二丁目,52,23,8,15
2016/9/30,141097,港北区,下田町二丁目,53,18,10,8
2016/9/30,141097,港北区,下田町二丁目,54,17,12,5
2016/9/30,141097,港北区,下田町二丁目,55,23,9,14
2016/9/30,141097,港北区,下田町二丁目,56,25,12,13
2016/9/30,141097,港北区,下田町二丁目,57,19,11,8
2016/9/30,141097,港北区,下田町二丁目,58,19,13,6
2016/9/30,141097,港北区,下田町二丁目,59,17,9,8
2016/9/30,141097,港北区,下田町二丁目,60,20,7,13
2016/9/30,141097,港北区,下田町二丁目,61,21,8,13
2016/9/30,141097,港北区,下田町二丁目,62,14,8,6
2016/9/30,141097,港北区,下田町二丁目,63,15,10,5
2016/9/30,141097,港北区,下田町二丁目,64,17,2,15
2016/9/30,141097,港北区,下田町二丁目,65,18,9,9
2016/9/30,141097,港北区,下田町二丁目,66,27,18,9
2016/9/30,141097,港北区,下田町二丁目,67,33,12,21
2016/9/30,141097,港北区,下田町二丁目,68,27,16,11
2016/9/30,141097,港北区,下田町二丁目,69,17,9,8
2016/9/30,141097,港北区,下田町二丁目,70,9,3,6
2016/9/30,141097,港北区,下田町二丁目,71,17,8,9
2016/9/30,141097,港北区,下田町二丁目,72,19,9,10
2016/9/30,141097,港北区,下田町二丁目,73,18,6,12
2016/9/30,141097,港北区,下田町二丁目,74,15,10,5
2016/9/30,141097,港北区,下田町二丁目,75,16,7,9
2016/9/30,141097,港北区,下田町二丁目,76,12,6,6
2016/9/30,141097,港北区,下田町二丁目,77,10,4,6
2016/9/30,141097,港北区,下田町二丁目,78,15,8,7
2016/9/30,141097,港北区,下田町二丁目,79,7,3,4
2016/9/30,141097,港北区,下田町二丁目,80,7,3,4
2016/9/30,141097,港北区,下田町二丁目,81,10,2,8
2016/9/30,141097,港北区,下田町二丁目,82,15,3,12
2016/9/30,141097,港北区,下田町二丁目,83,8,4,4
2016/9/30,141097,港北区,下田町二丁目,84,14,5,9
2016/9/30,141097,港北区,下田町二丁目,85,6,3,3
2016/9/30,141097,港北区,下田町二丁目,86,16,8,8
2016/9/30,141097,港北区,下田町二丁目,87,8,4,4
2016/9/30,141097,港北区,下田町二丁目,88,6,2,4
2016/9/30,141097,港北区,下田町二丁目,89,8,4,4
2016/9/30,141097,港北区,下田町二丁目,90,7,2,5
2016/9/30,141097,港北区,下田町二丁目,91,11,3,8
2016/9/30,141097,港北区,下田町二丁目,92,4,3,1
2016/9/30,141097,港北区,下田町二丁目,93,2,1,1
2016/9/30,141097,港北区,下田町二丁目,94,1,0,1
2016/9/30,141097,港北区,下田町二丁目,95,3,1,2
2016/9/30,141097,港北区,下田町二丁目,96,2,0,2
2016/9/30,141097,港北区,下田町二丁目,97,1,0,1
2016/9/30,141097,港北区,下田町二丁目,98,1,0,1
2016/9/30,141097,港北区,下田町二丁目,99,0,0,0
2016/9/30,141097,港北区,下田町二丁目,100,1,1,0
2016/9/30,141097,港北区,下田町三丁目,合計,2185,1092,1093
2016/9/30,141097,港北区,下田町三丁目,0,12,7,5
2016/9/30,141097,港北区,下田町三丁目,1,19,12,7
2016/9/30,141097,港北区,下田町三丁目,2,18,11,7
2016/9/30,141097,港北区,下田町三丁目,3,17,4,13
2016/9/30,141097,港北区,下田町三丁目,4,12,4,8
2016/9/30,141097,港北区,下田町三丁目,5,22,5,17
2016/9/30,141097,港北区,下田町三丁目,6,17,9,8
2016/9/30,141097,港北区,下田町三丁目,7,21,13,8
2016/9/30,141097,港北区,下田町三丁目,8,17,11,6
2016/9/30,141097,港北区,下田町三丁目,9,18,10,8
2016/9/30,141097,港北区,下田町三丁目,10,21,16,5
2016/9/30,141097,港北区,下田町三丁目,11,17,8,9
2016/9/30,141097,港北区,下田町三丁目,12,17,9,8
2016/9/30,141097,港北区,下田町三丁目,13,7,1,6
2016/9/30,141097,港北区,下田町三丁目,14,15,9,6
2016/9/30,141097,港北区,下田町三丁目,15,21,12,9
2016/9/30,141097,港北区,下田町三丁目,16,26,12,14
2016/9/30,141097,港北区,下田町三丁目,17,20,9,11
2016/9/30,141097,港北区,下田町三丁目,18,25,17,8
2016/9/30,141097,港北区,下田町三丁目,19,28,15,13
2016/9/30,141097,港北区,下田町三丁目,20,20,8,12
2016/9/30,141097,港北区,下田町三丁目,21,16,9,7
2016/9/30,141097,港北区,下田町三丁目,22,16,8,8
2016/9/30,141097,港北区,下田町三丁目,23,20,15,5
2016/9/30,141097,港北区,下田町三丁目,24,20,8,12
2016/9/30,141097,港北区,下田町三丁目,25,11,7,4
2016/9/30,141097,港北区,下田町三丁目,26,20,10,10
2016/9/30,141097,港北区,下田町三丁目,27,18,9,9
2016/9/30,141097,港北区,下田町三丁目,28,23,13,10
2016/9/30,141097,港北区,下田町三丁目,29,20,12,8
2016/9/30,141097,港北区,下田町三丁目,30,20,11,9
2016/9/30,141097,港北区,下田町三丁目,31,19,12,7
2016/9/30,141097,港北区,下田町三丁目,32,19,14,5
2016/9/30,141097,港北区,下田町三丁目,33,18,10,8
2016/9/30,141097,港北区,下田町三丁目,34,18,12,6
2016/9/30,141097,港北区,下田町三丁目,35,28,15,13
2016/9/30,141097,港北区,下田町三丁目,36,29,14,15
2016/9/30,141097,港北区,下田町三丁目,37,31,17,14
2016/9/30,141097,港北区,下田町三丁目,38,31,14,17
2016/9/30,141097,港北区,下田町三丁目,39,37,24,13
2016/9/30,141097,港北区,下田町三丁目,40,47,26,21
2016/9/30,141097,港北区,下田町三丁目,41,27,12,15
2016/9/30,141097,港北区,下田町三丁目,42,28,19,9
2016/9/30,141097,港北区,下田町三丁目,43,22,11,11
2016/9/30,141097,港北区,下田町三丁目,44,39,13,26
2016/9/30,141097,港北区,下田町三丁目,45,36,21,15
2016/9/30,141097,港北区,下田町三丁目,46,28,14,14
2016/9/30,141097,港北区,下田町三丁目,47,37,18,19
2016/9/30,141097,港北区,下田町三丁目,48,39,19,20
2016/9/30,141097,港北区,下田町三丁目,49,28,16,12
2016/9/30,141097,港北区,下田町三丁目,50,26,16,10
2016/9/30,141097,港北区,下田町三丁目,51,29,15,14
2016/9/30,141097,港北区,下田町三丁目,52,26,10,16
2016/9/30,141097,港北区,下田町三丁目,53,32,13,19
2016/9/30,141097,港北区,下田町三丁目,54,27,15,12
2016/9/30,141097,港北区,下田町三丁目,55,21,10,11
2016/9/30,141097,港北区,下田町三丁目,56,32,13,19
2016/9/30,141097,港北区,下田町三丁目,57,24,13,11
2016/9/30,141097,港北区,下田町三丁目,58,33,14,19
2016/9/30,141097,港北区,下田町三丁目,59,24,12,12
2016/9/30,141097,港北区,下田町三丁目,60,22,9,13
2016/9/30,141097,港北区,下田町三丁目,61,33,20,13
2016/9/30,141097,港北区,下田町三丁目,62,28,16,12
2016/9/30,141097,港北区,下田町三丁目,63,36,17,19
2016/9/30,141097,港北区,下田町三丁目,64,21,9,12
2016/9/30,141097,港北区,下田町三丁目,65,33,14,19
2016/9/30,141097,港北区,下田町三丁目,66,34,18,16
2016/9/30,141097,港北区,下田町三丁目,67,39,20,19
2016/9/30,141097,港北区,下田町三丁目,68,42,24,18
2016/9/30,141097,港北区,下田町三丁目,69,33,19,14
2016/9/30,141097,港北区,下田町三丁目,70,33,14,19
2016/9/30,141097,港北区,下田町三丁目,71,29,10,19
2016/9/30,141097,港北区,下田町三丁目,72,34,15,19
2016/9/30,141097,港北区,下田町三丁目,73,23,9,14
2016/9/30,141097,港北区,下田町三丁目,74,28,15,13
2016/9/30,141097,港北区,下田町三丁目,75,26,12,14
2016/9/30,141097,港北区,下田町三丁目,76,28,14,14
2016/9/30,141097,港北区,下田町三丁目,77,11,4,7
2016/9/30,141097,港北区,下田町三丁目,78,21,13,8
2016/9/30,141097,港北区,下田町三丁目,79,18,8,10
2016/9/30,141097,港北区,下田町三丁目,80,27,8,19
2016/9/30,141097,港北区,下田町三丁目,81,21,6,15
2016/9/30,141097,港北区,下田町三丁目,82,22,12,10
2016/9/30,141097,港北区,下田町三丁目,83,6,3,3
2016/9/30,141097,港北区,下田町三丁目,84,14,5,9
2016/9/30,141097,港北区,下田町三丁目,85,15,6,9
2016/9/30,141097,港北区,下田町三丁目,86,19,10,9
2016/9/30,141097,港北区,下田町三丁目,87,17,4,13
2016/9/30,141097,港北区,下田町三丁目,88,10,2,8
2016/9/30,141097,港北区,下田町三丁目,89,15,6,9
2016/9/30,141097,港北区,下田町三丁目,90,8,3,5
2016/9/30,141097,港北区,下田町三丁目,91,9,6,3
2016/9/30,141097,港北区,下田町三丁目,92,6,2,4
2016/9/30,141097,港北区,下田町三丁目,93,3,0,3
2016/9/30,141097,港北区,下田町三丁目,94,5,2,3
2016/9/30,141097,港北区,下田町三丁目,95,6,0,6
2016/9/30,141097,港北区,下田町三丁目,96,1,1,0
2016/9/30,141097,港北区,下田町三丁目,97,0,0,0
2016/9/30,141097,港北区,下田町三丁目,98,0,0,0
2016/9/30,141097,港北区,下田町三丁目,99,0,0,0
2016/9/30,141097,港北区,下田町三丁目,100,0,0,0
2016/9/30,141097,港北区,下田町四丁目,合計,2488,1168,1320
2016/9/30,141097,港北区,下田町四丁目,0,26,13,13
2016/9/30,141097,港北区,下田町四丁目,1,18,10,8
2016/9/30,141097,港北区,下田町四丁目,2,33,18,15
2016/9/30,141097,港北区,下田町四丁目,3,16,7,9
2016/9/30,141097,港北区,下田町四丁目,4,15,9,6
2016/9/30,141097,港北区,下田町四丁目,5,17,8,9
2016/9/30,141097,港北区,下田町四丁目,6,21,9,12
2016/9/30,141097,港北区,下田町四丁目,7,19,4,15
2016/9/30,141097,港北区,下田町四丁目,8,18,9,9
2016/9/30,141097,港北区,下田町四丁目,9,15,8,7
2016/9/30,141097,港北区,下田町四丁目,10,24,9,15
2016/9/30,141097,港北区,下田町四丁目,11,14,7,7
2016/9/30,141097,港北区,下田町四丁目,12,14,5,9
2016/9/30,141097,港北区,下田町四丁目,13,22,11,11
2016/9/30,141097,港北区,下田町四丁目,14,12,4,8
2016/9/30,141097,港北区,下田町四丁目,15,15,7,8
2016/9/30,141097,港北区,下田町四丁目,16,20,9,11
2016/9/30,141097,港北区,下田町四丁目,17,16,7,9
2016/9/30,141097,港北区,下田町四丁目,18,19,10,9
2016/9/30,141097,港北区,下田町四丁目,19,18,9,9
2016/9/30,141097,港北区,下田町四丁目,20,26,12,14
2016/9/30,141097,港北区,下田町四丁目,21,19,9,10
2016/9/30,141097,港北区,下田町四丁目,22,22,2,20
2016/9/30,141097,港北区,下田町四丁目,23,23,13,10
2016/9/30,141097,港北区,下田町四丁目,24,13,6,7
2016/9/30,141097,港北区,下田町四丁目,25,19,11,8
2016/9/30,141097,港北区,下田町四丁目,26,32,11,21
2016/9/30,141097,港北区,下田町四丁目,27,38,20,18
2016/9/30,141097,港北区,下田町四丁目,28,25,11,14
2016/9/30,141097,港北区,下田町四丁目,29,28,17,11
2016/9/30,141097,港北区,下田町四丁目,30,34,20,14
2016/9/30,141097,港北区,下田町四丁目,31,30,10,20
2016/9/30,141097,港北区,下田町四丁目,32,34,21,13
2016/9/30,141097,港北区,下田町四丁目,33,35,17,18
2016/9/30,141097,港北区,下田町四丁目,34,25,13,12
2016/9/30,141097,港北区,下田町四丁目,35,32,14,18
2016/9/30,141097,港北区,下田町四丁目,36,25,13,12
2016/9/30,141097,港北区,下田町四丁目,37,50,22,28
2016/9/30,141097,港北区,下田町四丁目,38,38,16,22
2016/9/30,141097,港北区,下田町四丁目,39,41,21,20
2016/9/30,141097,港北区,下田町四丁目,40,37,13,24
2016/9/30,141097,港北区,下田町四丁目,41,36,17,19
2016/9/30,141097,港北区,下田町四丁目,42,35,20,15
2016/9/30,141097,港北区,下田町四丁目,43,36,20,16
2016/9/30,141097,港北区,下田町四丁目,44,32,16,16
2016/9/30,141097,港北区,下田町四丁目,45,38,23,15
2016/9/30,141097,港北区,下田町四丁目,46,46,25,21
2016/9/30,141097,港北区,下田町四丁目,47,44,22,22
2016/9/30,141097,港北区,下田町四丁目,48,48,23,25
2016/9/30,141097,港北区,下田町四丁目,49,48,22,26
2016/9/30,141097,港北区,下田町四丁目,50,21,10,11
2016/9/30,141097,港北区,下田町四丁目,51,41,26,15
2016/9/30,141097,港北区,下田町四丁目,52,49,26,23
2016/9/30,141097,港北区,下田町四丁目,53,43,16,27
2016/9/30,141097,港北区,下田町四丁目,54,30,21,9
2016/9/30,141097,港北区,下田町四丁目,55,30,17,13
2016/9/30,141097,港北区,下田町四丁目,56,36,21,15
2016/9/30,141097,港北区,下田町四丁目,57,37,20,17
2016/9/30,141097,港北区,下田町四丁目,58,37,18,19
2016/9/30,141097,港北区,下田町四丁目,59,21,9,12
2016/9/30,141097,港北区,下田町四丁目,60,29,11,18
2016/9/30,141097,港北区,下田町四丁目,61,24,10,14
2016/9/30,141097,港北区,下田町四丁目,62,15,8,7
2016/9/30,141097,港北区,下田町四丁目,63,24,11,13
2016/9/30,141097,港北区,下田町四丁目,64,34,19,15
2016/9/30,141097,港北区,下田町四丁目,65,27,7,20
2016/9/30,141097,港北区,下田町四丁目,66,28,18,10
2016/9/30,141097,港北区,下田町四丁目,67,37,19,18
2016/9/30,141097,港北区,下田町四丁目,68,29,15,14
2016/9/30,141097,港北区,下田町四丁目,69,31,10,21
2016/9/30,141097,港北区,下田町四丁目,70,17,11,6
2016/9/30,141097,港北区,下田町四丁目,71,29,14,15
2016/9/30,141097,港北区,下田町四丁目,72,31,13,18
2016/9/30,141097,港北区,下田町四丁目,73,21,8,13
2016/9/30,141097,港北区,下田町四丁目,74,20,9,11
2016/9/30,141097,港北区,下田町四丁目,75,32,10,22
2016/9/30,141097,港北区,下田町四丁目,76,31,11,20
2016/9/30,141097,港北区,下田町四丁目,77,23,11,12
2016/9/30,141097,港北区,下田町四丁目,78,23,12,11
2016/9/30,141097,港北区,下田町四丁目,79,36,14,22
2016/9/30,141097,港北区,下田町四丁目,80,26,10,16
2016/9/30,141097,港北区,下田町四丁目,81,27,8,19
2016/9/30,141097,港北区,下田町四丁目,82,22,9,13
2016/9/30,141097,港北区,下田町四丁目,83,28,11,17
2016/9/30,141097,港北区,下田町四丁目,84,21,8,13
2016/9/30,141097,港北区,下田町四丁目,85,18,10,8
2016/9/30,141097,港北区,下田町四丁目,86,24,7,17
2016/9/30,141097,港北区,下田町四丁目,87,14,3,11
2016/9/30,141097,港北区,下田町四丁目,88,16,5,11
2016/9/30,141097,港北区,下田町四丁目,89,9,3,6
2016/9/30,141097,港北区,下田町四丁目,90,7,5,2
2016/9/30,141097,港北区,下田町四丁目,91,13,6,7
2016/9/30,141097,港北区,下田町四丁目,92,4,1,3
2016/9/30,141097,港北区,下田町四丁目,93,4,1,3
2016/9/30,141097,港北区,下田町四丁目,94,3,2,1
2016/9/30,141097,港北区,下田町四丁目,95,2,1,1
2016/9/30,141097,港北区,下田町四丁目,96,2,0,2
2016/9/30,141097,港北区,下田町四丁目,97,1,0,1
2016/9/30,141097,港北区,下田町四丁目,98,0,0,0
2016/9/30,141097,港北区,下田町四丁目,99,0,0,0
2016/9/30,141097,港北区,下田町四丁目,100,0,0,0
2016/9/30,141097,港北区,下田町五丁目,合計,3080,1523,1557
2016/9/30,141097,港北区,下田町五丁目,0,13,5,8
2016/9/30,141097,港北区,下田町五丁目,1,29,13,16
2016/9/30,141097,港北区,下田町五丁目,2,27,12,15
2016/9/30,141097,港北区,下田町五丁目,3,15,8,7
2016/9/30,141097,港北区,下田町五丁目,4,24,7,17
2016/9/30,141097,港北区,下田町五丁目,5,20,17,3
2016/9/30,141097,港北区,下田町五丁目,6,32,18,14
2016/9/30,141097,港北区,下田町五丁目,7,31,12,19
2016/9/30,141097,港北区,下田町五丁目,8,40,23,17
2016/9/30,141097,港北区,下田町五丁目,9,41,23,18
2016/9/30,141097,港北区,下田町五丁目,10,27,15,12
2016/9/30,141097,港北区,下田町五丁目,11,39,20,19
2016/9/30,141097,港北区,下田町五丁目,12,40,18,22
2016/9/30,141097,港北区,下田町五丁目,13,36,18,18
2016/9/30,141097,港北区,下田町五丁目,14,35,19,16
2016/9/30,141097,港北区,下田町五丁目,15,51,20,31
2016/9/30,141097,港北区,下田町五丁目,16,39,22,17
2016/9/30,141097,港北区,下田町五丁目,17,47,19,28
2016/9/30,141097,港北区,下田町五丁目,18,40,20,20
2016/9/30,141097,港北区,下田町五丁目,19,42,25,17
2016/9/30,141097,港北区,下田町五丁目,20,40,21,19
2016/9/30,141097,港北区,下田町五丁目,21,26,15,11
2016/9/30,141097,港北区,下田町五丁目,22,39,18,21
2016/9/30,141097,港北区,下田町五丁目,23,30,19,11
2016/9/30,141097,港北区,下田町五丁目,24,31,18,13
2016/9/30,141097,港北区,下田町五丁目,25,25,13,12
2016/9/30,141097,港北区,下田町五丁目,26,26,12,14
2016/9/30,141097,港北区,下田町五丁目,27,21,10,11
2016/9/30,141097,港北区,下田町五丁目,28,23,13,10
2016/9/30,141097,港北区,下田町五丁目,29,38,21,17
2016/9/30,141097,港北区,下田町五丁目,30,27,12,15
2016/9/30,141097,港北区,下田町五丁目,31,37,17,20
2016/9/30,141097,港北区,下田町五丁目,32,35,22,13
2016/9/30,141097,港北区,下田町五丁目,33,29,18,11
2016/9/30,141097,港北区,下田町五丁目,34,38,18,20
2016/9/30,141097,港北区,下田町五丁目,35,42,20,22
2016/9/30,141097,港北区,下田町五丁目,36,34,20,14
2016/9/30,141097,港北区,下田町五丁目,37,32,10,22
2016/9/30,141097,港北区,下田町五丁目,38,37,19,18
2016/9/30,141097,港北区,下田町五丁目,39,37,23,14
2016/9/30,141097,港北区,下田町五丁目,40,39,16,23
2016/9/30,141097,港北区,下田町五丁目,41,63,32,31
2016/9/30,141097,港北区,下田町五丁目,42,53,31,22
2016/9/30,141097,港北区,下田町五丁目,43,54,29,25
2016/9/30,141097,港北区,下田町五丁目,44,66,34,32
2016/9/30,141097,港北区,下田町五丁目,45,63,27,36
2016/9/30,141097,港北区,下田町五丁目,46,75,40,35
2016/9/30,141097,港北区,下田町五丁目,47,63,35,28
2016/9/30,141097,港北区,下田町五丁目,48,71,39,32
2016/9/30,141097,港北区,下田町五丁目,49,62,26,36
2016/9/30,141097,港北区,下田町五丁目,50,45,19,26
2016/9/30,141097,港北区,下田町五丁目,51,54,33,21
2016/9/30,141097,港北区,下田町五丁目,52,54,27,27
2016/9/30,141097,港北区,下田町五丁目,53,36,15,21
2016/9/30,141097,港北区,下田町五丁目,54,41,23,18
2016/9/30,141097,港北区,下田町五丁目,55,43,21,22
2016/9/30,141097,港北区,下田町五丁目,56,39,23,16
2016/9/30,141097,港北区,下田町五丁目,57,35,17,18
2016/9/30,141097,港北区,下田町五丁目,58,25,10,15
2016/9/30,141097,港北区,下田町五丁目,59,32,17,15
2016/9/30,141097,港北区,下田町五丁目,60,32,17,15
2016/9/30,141097,港北区,下田町五丁目,61,31,13,18
2016/9/30,141097,港北区,下田町五丁目,62,29,17,12
2016/9/30,141097,港北区,下田町五丁目,63,28,14,14
2016/9/30,141097,港北区,下田町五丁目,64,30,18,12
2016/9/30,141097,港北区,下田町五丁目,65,25,13,12
2016/9/30,141097,港北区,下田町五丁目,66,23,8,15
2016/9/30,141097,港北区,下田町五丁目,67,40,15,25
2016/9/30,141097,港北区,下田町五丁目,68,38,18,20
2016/9/30,141097,港北区,下田町五丁目,69,41,24,17
2016/9/30,141097,港北区,下田町五丁目,70,30,14,16
2016/9/30,141097,港北区,下田町五丁目,71,26,9,17
2016/9/30,141097,港北区,下田町五丁目,72,31,12,19
2016/9/30,141097,港北区,下田町五丁目,73,25,9,16
2016/9/30,141097,港北区,下田町五丁目,74,20,6,14
2016/9/30,141097,港北区,下田町五丁目,75,38,21,17
2016/9/30,141097,港北区,下田町五丁目,76,19,11,8
2016/9/30,141097,港北区,下田町五丁目,77,23,9,14
2016/9/30,141097,港北区,下田町五丁目,78,27,13,14
2016/9/30,141097,港北区,下田町五丁目,79,32,10,22
2016/9/30,141097,港北区,下田町五丁目,80,19,13,6
2016/9/30,141097,港北区,下田町五丁目,81,24,10,14
2016/9/30,141097,港北区,下田町五丁目,82,24,11,13
2016/9/30,141097,港北区,下田町五丁目,83,24,8,16
2016/9/30,141097,港北区,下田町五丁目,84,11,6,5
2016/9/30,141097,港北区,下田町五丁目,85,14,2,12
2016/9/30,141097,港北区,下田町五丁目,86,7,4,3
2016/9/30,141097,港北区,下田町五丁目,87,9,2,7
2016/9/30,141097,港北区,下田町五丁目,88,4,0,4
2016/9/30,141097,港北区,下田町五丁目,89,6,4,2
2016/9/30,141097,港北区,下田町五丁目,90,4,1,3
2016/9/30,141097,港北区,下田町五丁目,91,3,2,1
2016/9/30,141097,港北区,下田町五丁目,92,5,1,4
2016/9/30,141097,港北区,下田町五丁目,93,3,1,2
2016/9/30,141097,港北区,下田町五丁目,94,1,0,1
2016/9/30,141097,港北区,下田町五丁目,95,3,0,3
2016/9/30,141097,港北区,下田町五丁目,96,2,0,2
2016/9/30,141097,港北区,下田町五丁目,97,1,0,1
2016/9/30,141097,港北区,下田町五丁目,98,0,0,0
2016/9/30,141097,港北区,下田町五丁目,99,0,0,0
2016/9/30,141097,港北区,下田町五丁目,100,0,0,0
2016/9/30,141097,港北区,下田町六丁目,合計,2922,1425,1497
2016/9/30,141097,港北区,下田町六丁目,0,17,5,12
2016/9/30,141097,港北区,下田町六丁目,1,13,5,8
2016/9/30,141097,港北区,下田町六丁目,2,29,16,13
2016/9/30,141097,港北区,下田町六丁目,3,28,18,10
2016/9/30,141097,港北区,下田町六丁目,4,21,9,12
2016/9/30,141097,港北区,下田町六丁目,5,28,16,12
2016/9/30,141097,港北区,下田町六丁目,6,21,8,13
2016/9/30,141097,港北区,下田町六丁目,7,39,19,20
2016/9/30,141097,港北区,下田町六丁目,8,34,14,20
2016/9/30,141097,港北区,下田町六丁目,9,21,14,7
2016/9/30,141097,港北区,下田町六丁目,10,30,21,9
2016/9/30,141097,港北区,下田町六丁目,11,28,14,14
2016/9/30,141097,港北区,下田町六丁目,12,34,18,16
2016/9/30,141097,港北区,下田町六丁目,13,31,18,13
2016/9/30,141097,港北区,下田町六丁目,14,31,14,17
2016/9/30,141097,港北区,下田町六丁目,15,36,20,16
2016/9/30,141097,港北区,下田町六丁目,16,30,19,11
2016/9/30,141097,港北区,下田町六丁目,17,34,14,20
2016/9/30,141097,港北区,下田町六丁目,18,33,18,15
2016/9/30,141097,港北区,下田町六丁目,19,31,12,19
2016/9/30,141097,港北区,下田町六丁目,20,27,14,13
2016/9/30,141097,港北区,下田町六丁目,21,32,16,16
2016/9/30,141097,港北区,下田町六丁目,22,29,18,11
2016/9/30,141097,港北区,下田町六丁目,23,33,15,18
2016/9/30,141097,港北区,下田町六丁目,24,24,13,11
2016/9/30,141097,港北区,下田町六丁目,25,27,13,14
2016/9/30,141097,港北区,下田町六丁目,26,32,13,19
2016/9/30,141097,港北区,下田町六丁目,27,16,12,4
2016/9/30,141097,港北区,下田町六丁目,28,26,13,13
2016/9/30,141097,港北区,下田町六丁目,29,23,17,6
2016/9/30,141097,港北区,下田町六丁目,30,28,15,13
2016/9/30,141097,港北区,下田町六丁目,31,19,8,11
2016/9/30,141097,港北区,下田町六丁目,32,30,15,15
2016/9/30,141097,港北区,下田町六丁目,33,25,16,9
2016/9/30,141097,港北区,下田町六丁目,34,28,13,15
2016/9/30,141097,港北区,下田町六丁目,35,24,14,10
2016/9/30,141097,港北区,下田町六丁目,36,29,18,11
2016/9/30,141097,港北区,下田町六丁目,37,34,21,13
2016/9/30,141097,港北区,下田町六丁目,38,36,16,20
2016/9/30,141097,港北区,下田町六丁目,39,32,13,19
2016/9/30,141097,港北区,下田町六丁目,40,35,19,16
2016/9/30,141097,港北区,下田町六丁目,41,55,31,24
2016/9/30,141097,港北区,下田町六丁目,42,52,30,22
2016/9/30,141097,港北区,下田町六丁目,43,44,18,26
2016/9/30,141097,港北区,下田町六丁目,44,71,34,37
2016/9/30,141097,港北区,下田町六丁目,45,54,29,25
2016/9/30,141097,港北区,下田町六丁目,46,76,35,41
2016/9/30,141097,港北区,下田町六丁目,47,46,24,22
2016/9/30,141097,港北区,下田町六丁目,48,54,23,31
2016/9/30,141097,港北区,下田町六丁目,49,53,26,27
2016/9/30,141097,港北区,下田町六丁目,50,48,27,21
2016/9/30,141097,港北区,下田町六丁目,51,48,26,22
2016/9/30,141097,港北区,下田町六丁目,52,35,17,18
2016/9/30,141097,港北区,下田町六丁目,53,43,25,18
2016/9/30,141097,港北区,下田町六丁目,54,40,15,25
2016/9/30,141097,港北区,下田町六丁目,55,35,19,16
2016/9/30,141097,港北区,下田町六丁目,56,48,23,25
2016/9/30,141097,港北区,下田町六丁目,57,36,14,22
2016/9/30,141097,港北区,下田町六丁目,58,41,19,22
2016/9/30,141097,港北区,下田町六丁目,59,33,17,16
2016/9/30,141097,港北区,下田町六丁目,60,40,22,18
2016/9/30,141097,港北区,下田町六丁目,61,23,16,7
2016/9/30,141097,港北区,下田町六丁目,62,21,12,9
2016/9/30,141097,港北区,下田町六丁目,63,35,16,19
2016/9/30,141097,港北区,下田町六丁目,64,26,13,13
2016/9/30,141097,港北区,下田町六丁目,65,30,12,18
2016/9/30,141097,港北区,下田町六丁目,66,35,13,22
2016/9/30,141097,港北区,下田町六丁目,67,38,19,19
2016/9/30,141097,港北区,下田町六丁目,68,40,22,18
2016/9/30,141097,港北区,下田町六丁目,69,36,18,18
2016/9/30,141097,港北区,下田町六丁目,70,22,9,13
2016/9/30,141097,港北区,下田町六丁目,71,29,10,19
2016/9/30,141097,港北区,下田町六丁目,72,25,9,16
2016/9/30,141097,港北区,下田町六丁目,73,34,12,22
2016/9/30,141097,港北区,下田町六丁目,74,41,22,19
2016/9/30,141097,港北区,下田町六丁目,75,36,17,19
2016/9/30,141097,港北区,下田町六丁目,76,20,11,9
2016/9/30,141097,港北区,下田町六丁目,77,17,6,11
2016/9/30,141097,港北区,下田町六丁目,78,20,9,11
2016/9/30,141097,港北区,下田町六丁目,79,31,17,14
2016/9/30,141097,港北区,下田町六丁目,80,31,15,16
2016/9/30,141097,港北区,下田町六丁目,81,24,8,16
2016/9/30,141097,港北区,下田町六丁目,82,29,5,24
2016/9/30,141097,港北区,下田町六丁目,83,24,8,16
2016/9/30,141097,港北区,下田町六丁目,84,19,5,14
2016/9/30,141097,港北区,下田町六丁目,85,23,10,13
2016/9/30,141097,港北区,下田町六丁目,86,18,9,9
2016/9/30,141097,港北区,下田町六丁目,87,17,7,10
2016/9/30,141097,港北区,下田町六丁目,88,12,4,8
2016/9/30,141097,港北区,下田町六丁目,89,5,3,2
2016/9/30,141097,港北区,下田町六丁目,90,12,3,9
2016/9/30,141097,港北区,下田町六丁目,91,10,3,7
2016/9/30,141097,港北区,下田町六丁目,92,7,0,7
2016/9/30,141097,港北区,下田町六丁目,93,4,0,4
2016/9/30,141097,港北区,下田町六丁目,94,3,0,3
2016/9/30,141097,港北区,下田町六丁目,95,6,2,4
2016/9/30,141097,港北区,下田町六丁目,96,1,0,1
2016/9/30,141097,港北区,下田町六丁目,97,5,1,4
2016/9/30,141097,港北区,下田町六丁目,98,2,1,1
2016/9/30,141097,港北区,下田町六丁目,99,0,0,0
2016/9/30,141097,港北区,下田町六丁目,100,1,0,1
2016/9/30,141097,港北区,新吉田町,合計,4436,2283,2153
2016/9/30,141097,港北区,新吉田町,0,36,20,16
2016/9/30,141097,港北区,新吉田町,1,34,15,19
2016/9/30,141097,港北区,新吉田町,2,42,27,15
2016/9/30,141097,港北区,新吉田町,3,25,15,10
2016/9/30,141097,港北区,新吉田町,4,38,20,18
2016/9/30,141097,港北区,新吉田町,5,31,18,13
2016/9/30,141097,港北区,新吉田町,6,33,15,18
2016/9/30,141097,港北区,新吉田町,7,29,16,13
2016/9/30,141097,港北区,新吉田町,8,37,20,17
2016/9/30,141097,港北区,新吉田町,9,32,17,15
2016/9/30,141097,港北区,新吉田町,10,28,10,18
2016/9/30,141097,港北区,新吉田町,11,32,13,19
2016/9/30,141097,港北区,新吉田町,12,38,20,18
2016/9/30,141097,港北区,新吉田町,13,22,11,11
2016/9/30,141097,港北区,新吉田町,14,32,14,18
2016/9/30,141097,港北区,新吉田町,15,31,20,11
2016/9/30,141097,港北区,新吉田町,16,53,22,31
2016/9/30,141097,港北区,新吉田町,17,34,25,9
2016/9/30,141097,港北区,新吉田町,18,44,26,18
2016/9/30,141097,港北区,新吉田町,19,44,21,23
2016/9/30,141097,港北区,新吉田町,20,45,25,20
2016/9/30,141097,港北区,新吉田町,21,36,22,14
2016/9/30,141097,港北区,新吉田町,22,33,20,13
2016/9/30,141097,港北区,新吉田町,23,42,20,22
2016/9/30,141097,港北区,新吉田町,24,36,24,12
2016/9/30,141097,港北区,新吉田町,25,39,26,13
2016/9/30,141097,港北区,新吉田町,26,37,20,17
2016/9/30,141097,港北区,新吉田町,27,48,26,22
2016/9/30,141097,港北区,新吉田町,28,37,24,13
2016/9/30,141097,港北区,新吉田町,29,47,25,22
2016/9/30,141097,港北区,新吉田町,30,39,20,19
2016/9/30,141097,港北区,新吉田町,31,40,26,14
2016/9/30,141097,港北区,新吉田町,32,42,24,18
2016/9/30,141097,港北区,新吉田町,33,48,27,21
2016/9/30,141097,港北区,新吉田町,34,62,31,31
2016/9/30,141097,港北区,新吉田町,35,56,34,22
2016/9/30,141097,港北区,新吉田町,36,55,27,28
2016/9/30,141097,港北区,新吉田町,37,53,25,28
2016/9/30,141097,港北区,新吉田町,38,61,37,24
2016/9/30,141097,港北区,新吉田町,39,56,26,30
2016/9/30,141097,港北区,新吉田町,40,64,34,30
2016/9/30,141097,港北区,新吉田町,41,57,35,22
2016/9/30,141097,港北区,新吉田町,42,91,49,42
2016/9/30,141097,港北区,新吉田町,43,78,46,32
2016/9/30,141097,港北区,新吉田町,44,77,48,29
2016/9/30,141097,港北区,新吉田町,45,80,40,40
2016/9/30,141097,港北区,新吉田町,46,78,43,35
2016/9/30,141097,港北区,新吉田町,47,89,46,43
2016/9/30,141097,港北区,新吉田町,48,87,57,30
2016/9/30,141097,港北区,新吉田町,49,71,31,40
2016/9/30,141097,港北区,新吉田町,50,58,33,25
2016/9/30,141097,港北区,新吉田町,51,62,35,27
2016/9/30,141097,港北区,新吉田町,52,58,36,22
2016/9/30,141097,港北区,新吉田町,53,43,27,16
2016/9/30,141097,港北区,新吉田町,54,40,24,16
2016/9/30,141097,港北区,新吉田町,55,52,29,23
2016/9/30,141097,港北区,新吉田町,56,43,20,23
2016/9/30,141097,港北区,新吉田町,57,41,20,21
2016/9/30,141097,港北区,新吉田町,58,36,23,13
2016/9/30,141097,港北区,新吉田町,59,38,17,21
2016/9/30,141097,港北区,新吉田町,60,45,21,24
2016/9/30,141097,港北区,新吉田町,61,48,26,22
2016/9/30,141097,港北区,新吉田町,62,53,23,30
2016/9/30,141097,港北区,新吉田町,63,50,23,27
2016/9/30,141097,港北区,新吉田町,64,64,36,28
2016/9/30,141097,港北区,新吉田町,65,33,14,19
2016/9/30,141097,港北区,新吉田町,66,68,39,29
2016/9/30,141097,港北区,新吉田町,67,70,33,37
2016/9/30,141097,港北区,新吉田町,68,80,33,47
2016/9/30,141097,港北区,新吉田町,69,79,39,40
2016/9/30,141097,港北区,新吉田町,70,40,18,22
2016/9/30,141097,港北区,新吉田町,71,55,32,23
2016/9/30,141097,港北区,新吉田町,72,73,35,38
2016/9/30,141097,港北区,新吉田町,73,74,28,46
2016/9/30,141097,港北区,新吉田町,74,69,28,41
2016/9/30,141097,港北区,新吉田町,75,73,29,44
2016/9/30,141097,港北区,新吉田町,76,59,32,27
2016/9/30,141097,港北区,新吉田町,77,58,25,33
2016/9/30,141097,港北区,新吉田町,78,58,30,28
2016/9/30,141097,港北区,新吉田町,79,45,21,24
2016/9/30,141097,港北区,新吉田町,80,57,26,31
2016/9/30,141097,港北区,新吉田町,81,43,19,24
2016/9/30,141097,港北区,新吉田町,82,33,16,17
2016/9/30,141097,港北区,新吉田町,83,36,17,19
2016/9/30,141097,港北区,新吉田町,84,32,15,17
2016/9/30,141097,港北区,新吉田町,85,27,12,15
2016/9/30,141097,港北区,新吉田町,86,30,9,21
2016/9/30,141097,港北区,新吉田町,87,19,5,14
2016/9/30,141097,港北区,新吉田町,88,20,10,10
2016/9/30,141097,港北区,新吉田町,89,15,3,12
2016/9/30,141097,港北区,新吉田町,90,22,4,18
2016/9/30,141097,港北区,新吉田町,91,13,4,9
2016/9/30,141097,港北区,新吉田町,92,14,4,10
2016/9/30,141097,港北区,新吉田町,93,11,4,7
2016/9/30,141097,港北区,新吉田町,94,7,0,7
2016/9/30,141097,港北区,新吉田町,95,4,2,2
2016/9/30,141097,港北区,新吉田町,96,4,1,3
2016/9/30,141097,港北区,新吉田町,97,2,0,2
2016/9/30,141097,港北区,新吉田町,98,1,0,1
2016/9/30,141097,港北区,新吉田町,99,0,0,0
2016/9/30,141097,港北区,新吉田町,100,2,0,2
2016/9/30,141097,港北区,高田町,合計,760,393,367
2016/9/30,141097,港北区,高田町,0,5,2,3
2016/9/30,141097,港北区,高田町,1,0,0,0
2016/9/30,141097,港北区,高田町,2,1,1,0
2016/9/30,141097,港北区,高田町,3,7,5,2
2016/9/30,141097,港北区,高田町,4,6,4,2
2016/9/30,141097,港北区,高田町,5,4,1,3
2016/9/30,141097,港北区,高田町,6,4,3,1
2016/9/30,141097,港北区,高田町,7,3,2,1
2016/9/30,141097,港北区,高田町,8,5,2,3
2016/9/30,141097,港北区,高田町,9,7,3,4
2016/9/30,141097,港北区,高田町,10,5,4,1
2016/9/30,141097,港北区,高田町,11,9,5,4
2016/9/30,141097,港北区,高田町,12,7,5,2
2016/9/30,141097,港北区,高田町,13,8,5,3
2016/9/30,141097,港北区,高田町,14,3,3,0
2016/9/30,141097,港北区,高田町,15,10,7,3
2016/9/30,141097,港北区,高田町,16,8,5,3
2016/9/30,141097,港北区,高田町,17,6,4,2
2016/9/30,141097,港北区,高田町,18,9,4,5
2016/9/30,141097,港北区,高田町,19,11,6,5
2016/9/30,141097,港北区,高田町,20,5,3,2
2016/9/30,141097,港北区,高田町,21,9,2,7
2016/9/30,141097,港北区,高田町,22,6,5,1
2016/9/30,141097,港北区,高田町,23,8,5,3
2016/9/30,141097,港北区,高田町,24,4,2,2
2016/9/30,141097,港北区,高田町,25,8,5,3
2016/9/30,141097,港北区,高田町,26,4,0,4
2016/9/30,141097,港北区,高田町,27,7,2,5
2016/9/30,141097,港北区,高田町,28,1,1,0
2016/9/30,141097,港北区,高田町,29,6,4,2
2016/9/30,141097,港北区,高田町,30,3,2,1
2016/9/30,141097,港北区,高田町,31,7,4,3
2016/9/30,141097,港北区,高田町,32,4,3,1
2016/9/30,141097,港北区,高田町,33,5,1,4
2016/9/30,141097,港北区,高田町,34,7,3,4
2016/9/30,141097,港北区,高田町,35,9,5,4
2016/9/30,141097,港北区,高田町,36,10,4,6
2016/9/30,141097,港北区,高田町,37,7,3,4
2016/9/30,141097,港北区,高田町,38,4,1,3
2016/9/30,141097,港北区,高田町,39,9,6,3
2016/9/30,141097,港北区,高田町,40,11,5,6
2016/9/30,141097,港北区,高田町,41,10,4,6
2016/9/30,141097,港北区,高田町,42,11,7,4
2016/9/30,141097,港北区,高田町,43,12,7,5
2016/9/30,141097,港北区,高田町,44,19,8,11
2016/9/30,141097,港北区,高田町,45,14,6,8
2016/9/30,141097,港北区,高田町,46,17,11,6
2016/9/30,141097,港北区,高田町,47,18,6,12
2016/9/30,141097,港北区,高田町,48,14,12,2
2016/9/30,141097,港北区,高田町,49,19,14,5
2016/9/30,141097,港北区,高田町,50,8,2,6
2016/9/30,141097,港北区,高田町,51,14,7,7
2016/9/30,141097,港北区,高田町,52,11,8,3
2016/9/30,141097,港北区,高田町,53,9,5,4
2016/9/30,141097,港北区,高田町,54,11,5,6
2016/9/30,141097,港北区,高田町,55,10,3,7
2016/9/30,141097,港北区,高田町,56,10,8,2
2016/9/30,141097,港北区,高田町,57,9,4,5
2016/9/30,141097,港北区,高田町,58,8,3,5
2016/9/30,141097,港北区,高田町,59,11,9,2
2016/9/30,141097,港北区,高田町,60,5,4,1
2016/9/30,141097,港北区,高田町,61,4,2,2
2016/9/30,141097,港北区,高田町,62,17,8,9
2016/9/30,141097,港北区,高田町,63,7,4,3
2016/9/30,141097,港北区,高田町,64,8,1,7
2016/9/30,141097,港北区,高田町,65,11,7,4
2016/9/30,141097,港北区,高田町,66,14,7,7
2016/9/30,141097,港北区,高田町,67,16,9,7
2016/9/30,141097,港北区,高田町,68,12,7,5
2016/9/30,141097,港北区,高田町,69,6,2,4
2016/9/30,141097,港北区,高田町,70,8,5,3
2016/9/30,141097,港北区,高田町,71,12,3,9
2016/9/30,141097,港北区,高田町,72,9,4,5
2016/9/30,141097,港北区,高田町,73,12,7,5
2016/9/30,141097,港北区,高田町,74,11,6,5
2016/9/30,141097,港北区,高田町,75,10,3,7
2016/9/30,141097,港北区,高田町,76,13,8,5
2016/9/30,141097,港北区,高田町,77,7,2,5
2016/9/30,141097,港北区,高田町,78,8,2,6
2016/9/30,141097,港北区,高田町,79,7,2,5
2016/9/30,141097,港北区,高田町,80,4,1,3
2016/9/30,141097,港北区,高田町,81,10,6,4
2016/9/30,141097,港北区,高田町,82,7,2,5
2016/9/30,141097,港北区,高田町,83,5,2,3
2016/9/30,141097,港北区,高田町,84,10,4,6
2016/9/30,141097,港北区,高田町,85,9,5,4
2016/9/30,141097,港北区,高田町,86,5,4,1
2016/9/30,141097,港北区,高田町,87,3,1,2
2016/9/30,141097,港北区,高田町,88,5,3,2
2016/9/30,141097,港北区,高田町,89,5,1,4
2016/9/30,141097,港北区,高田町,90,3,2,1
2016/9/30,141097,港北区,高田町,91,1,0,1
2016/9/30,141097,港北区,高田町,92,2,0,2
2016/9/30,141097,港北区,高田町,93,0,0,0
2016/9/30,141097,港北区,高田町,94,1,1,0
2016/9/30,141097,港北区,高田町,95,0,0,0
2016/9/30,141097,港北区,高田町,96,1,0,1
2016/9/30,141097,港北区,高田町,97,0,0,0
2016/9/30,141097,港北区,高田町,98,2,1,1
2016/9/30,141097,港北区,高田町,99,2,1,1
2016/9/30,141097,港北区,高田町,100,1,0,1
2016/9/30,141097,港北区,仲手原一丁目,合計,3314,1533,1781
2016/9/30,141097,港北区,仲手原一丁目,0,15,7,8
2016/9/30,141097,港北区,仲手原一丁目,1,20,14,6
2016/9/30,141097,港北区,仲手原一丁目,2,34,19,15
2016/9/30,141097,港北区,仲手原一丁目,3,31,15,16
2016/9/30,141097,港北区,仲手原一丁目,4,21,9,12
2016/9/30,141097,港北区,仲手原一丁目,5,30,19,11
2016/9/30,141097,港北区,仲手原一丁目,6,24,11,13
2016/9/30,141097,港北区,仲手原一丁目,7,27,15,12
2016/9/30,141097,港北区,仲手原一丁目,8,22,10,12
2016/9/30,141097,港北区,仲手原一丁目,9,20,12,8
2016/9/30,141097,港北区,仲手原一丁目,10,25,14,11
2016/9/30,141097,港北区,仲手原一丁目,11,16,9,7
2016/9/30,141097,港北区,仲手原一丁目,12,19,15,4
2016/9/30,141097,港北区,仲手原一丁目,13,21,12,9
2016/9/30,141097,港北区,仲手原一丁目,14,26,13,13
2016/9/30,141097,港北区,仲手原一丁目,15,21,10,11
2016/9/30,141097,港北区,仲手原一丁目,16,28,9,19
2016/9/30,141097,港北区,仲手原一丁目,17,44,27,17
2016/9/30,141097,港北区,仲手原一丁目,18,22,7,15
2016/9/30,141097,港北区,仲手原一丁目,19,28,13,15
2016/9/30,141097,港北区,仲手原一丁目,20,24,14,10
2016/9/30,141097,港北区,仲手原一丁目,21,33,12,21
2016/9/30,141097,港北区,仲手原一丁目,22,31,15,16
2016/9/30,141097,港北区,仲手原一丁目,23,37,20,17
2016/9/30,141097,港北区,仲手原一丁目,24,42,19,23
2016/9/30,141097,港北区,仲手原一丁目,25,49,23,26
2016/9/30,141097,港北区,仲手原一丁目,26,52,23,29
2016/9/30,141097,港北区,仲手原一丁目,27,59,27,32
2016/9/30,141097,港北区,仲手原一丁目,28,59,22,37
2016/9/30,141097,港北区,仲手原一丁目,29,55,33,22
2016/9/30,141097,港北区,仲手原一丁目,30,37,16,21
2016/9/30,141097,港北区,仲手原一丁目,31,41,15,26
2016/9/30,141097,港北区,仲手原一丁目,32,57,19,38
2016/9/30,141097,港北区,仲手原一丁目,33,46,26,20
2016/9/30,141097,港北区,仲手原一丁目,34,38,18,20
2016/9/30,141097,港北区,仲手原一丁目,35,43,23,20
2016/9/30,141097,港北区,仲手原一丁目,36,41,19,22
2016/9/30,141097,港北区,仲手原一丁目,37,43,22,21
2016/9/30,141097,港北区,仲手原一丁目,38,43,17,26
2016/9/30,141097,港北区,仲手原一丁目,39,58,27,31
2016/9/30,141097,港北区,仲手原一丁目,40,51,22,29
2016/9/30,141097,港北区,仲手原一丁目,41,63,35,28
2016/9/30,141097,港北区,仲手原一丁目,42,65,24,41
2016/9/30,141097,港北区,仲手原一丁目,43,61,26,35
2016/9/30,141097,港北区,仲手原一丁目,44,60,35,25
2016/9/30,141097,港北区,仲手原一丁目,45,45,16,29
2016/9/30,141097,港北区,仲手原一丁目,46,43,23,20
2016/9/30,141097,港北区,仲手原一丁目,47,65,27,38
2016/9/30,141097,港北区,仲手原一丁目,48,45,24,21
2016/9/30,141097,港北区,仲手原一丁目,49,55,29,26
2016/9/30,141097,港北区,仲手原一丁目,50,38,18,20
2016/9/30,141097,港北区,仲手原一丁目,51,54,23,31
2016/9/30,141097,港北区,仲手原一丁目,52,51,26,25
2016/9/30,141097,港北区,仲手原一丁目,53,33,14,19
2016/9/30,141097,港北区,仲手原一丁目,54,53,29,24
2016/9/30,141097,港北区,仲手原一丁目,55,43,17,26
2016/9/30,141097,港北区,仲手原一丁目,56,47,24,23
2016/9/30,141097,港北区,仲手原一丁目,57,43,20,23
2016/9/30,141097,港北区,仲手原一丁目,58,43,24,19
2016/9/30,141097,港北区,仲手原一丁目,59,43,21,22
2016/9/30,141097,港北区,仲手原一丁目,60,28,9,19
2016/9/30,141097,港北区,仲手原一丁目,61,36,16,20
2016/9/30,141097,港北区,仲手原一丁目,62,40,19,21
2016/9/30,141097,港北区,仲手原一丁目,63,33,17,16
2016/9/30,141097,港北区,仲手原一丁目,64,37,16,21
2016/9/30,141097,港北区,仲手原一丁目,65,48,27,21
2016/9/30,141097,港北区,仲手原一丁目,66,47,26,21
2016/9/30,141097,港北区,仲手原一丁目,67,59,28,31
2016/9/30,141097,港北区,仲手原一丁目,68,47,23,24
2016/9/30,141097,港北区,仲手原一丁目,69,39,18,21
2016/9/30,141097,港北区,仲手原一丁目,70,24,8,16
2016/9/30,141097,港北区,仲手原一丁目,71,14,8,6
2016/9/30,141097,港北区,仲手原一丁目,72,34,14,20
2016/9/30,141097,港北区,仲手原一丁目,73,26,11,15
2016/9/30,141097,港北区,仲手原一丁目,74,41,14,27
2016/9/30,141097,港北区,仲手原一丁目,75,29,7,22
2016/9/30,141097,港北区,仲手原一丁目,76,25,9,16
2016/9/30,141097,港北区,仲手原一丁目,77,31,15,16
2016/9/30,141097,港北区,仲手原一丁目,78,23,8,15
2016/9/30,141097,港北区,仲手原一丁目,79,26,11,15
2016/9/30,141097,港北区,仲手原一丁目,80,39,17,22
2016/9/30,141097,港北区,仲手原一丁目,81,30,9,21
2016/9/30,141097,港北区,仲手原一丁目,82,25,14,11
2016/9/30,141097,港北区,仲手原一丁目,83,22,12,10
2016/9/30,141097,港北区,仲手原一丁目,84,22,6,16
2016/9/30,141097,港北区,仲手原一丁目,85,19,3,16
2016/9/30,141097,港北区,仲手原一丁目,86,10,3,7
2016/9/30,141097,港北区,仲手原一丁目,87,16,7,9
2016/9/30,141097,港北区,仲手原一丁目,88,11,1,10
2016/9/30,141097,港北区,仲手原一丁目,89,8,2,6
2016/9/30,141097,港北区,仲手原一丁目,90,7,1,6
2016/9/30,141097,港北区,仲手原一丁目,91,12,3,9
2016/9/30,141097,港北区,仲手原一丁目,92,4,0,4
2016/9/30,141097,港北区,仲手原一丁目,93,4,1,3
2016/9/30,141097,港北区,仲手原一丁目,94,5,3,2
2016/9/30,141097,港北区,仲手原一丁目,95,2,0,2
2016/9/30,141097,港北区,仲手原一丁目,96,0,0,0
2016/9/30,141097,港北区,仲手原一丁目,97,5,0,5
2016/9/30,141097,港北区,仲手原一丁目,98,2,0,2
2016/9/30,141097,港北区,仲手原一丁目,99,0,0,0
2016/9/30,141097,港北区,仲手原一丁目,100,1,0,1
2016/9/30,141097,港北区,仲手原二丁目,合計,3422,1667,1755
2016/9/30,141097,港北区,仲手原二丁目,0,24,13,11
2016/9/30,141097,港北区,仲手原二丁目,1,27,17,10
2016/9/30,141097,港北区,仲手原二丁目,2,16,9,7
2016/9/30,141097,港北区,仲手原二丁目,3,24,12,12
2016/9/30,141097,港北区,仲手原二丁目,4,24,11,13
2016/9/30,141097,港北区,仲手原二丁目,5,23,13,10
2016/9/30,141097,港北区,仲手原二丁目,6,21,13,8
2016/9/30,141097,港北区,仲手原二丁目,7,17,7,10
2016/9/30,141097,港北区,仲手原二丁目,8,16,11,5
2016/9/30,141097,港北区,仲手原二丁目,9,17,11,6
2016/9/30,141097,港北区,仲手原二丁目,10,26,13,13
2016/9/30,141097,港北区,仲手原二丁目,11,18,11,7
2016/9/30,141097,港北区,仲手原二丁目,12,16,3,13
2016/9/30,141097,港北区,仲手原二丁目,13,20,10,10
2016/9/30,141097,港北区,仲手原二丁目,14,23,8,15
2016/9/30,141097,港北区,仲手原二丁目,15,15,11,4
2016/9/30,141097,港北区,仲手原二丁目,16,25,13,12
2016/9/30,141097,港北区,仲手原二丁目,17,19,10,9
2016/9/30,141097,港北区,仲手原二丁目,18,23,13,10
2016/9/30,141097,港北区,仲手原二丁目,19,39,23,16
2016/9/30,141097,港北区,仲手原二丁目,20,23,13,10
2016/9/30,141097,港北区,仲手原二丁目,21,45,18,27
2016/9/30,141097,港北区,仲手原二丁目,22,34,15,19
2016/9/30,141097,港北区,仲手原二丁目,23,42,18,24
2016/9/30,141097,港北区,仲手原二丁目,24,51,21,30
2016/9/30,141097,港北区,仲手原二丁目,25,54,29,25
2016/9/30,141097,港北区,仲手原二丁目,26,60,27,33
2016/9/30,141097,港北区,仲手原二丁目,27,43,22,21
2016/9/30,141097,港北区,仲手原二丁目,28,70,35,35
2016/9/30,141097,港北区,仲手原二丁目,29,58,21,37
2016/9/30,141097,港北区,仲手原二丁目,30,47,22,25
2016/9/30,141097,港北区,仲手原二丁目,31,45,25,20
2016/9/30,141097,港北区,仲手原二丁目,32,65,33,32
2016/9/30,141097,港北区,仲手原二丁目,33,59,27,32
2016/9/30,141097,港北区,仲手原二丁目,34,58,30,28
2016/9/30,141097,港北区,仲手原二丁目,35,50,30,20
2016/9/30,141097,港北区,仲手原二丁目,36,59,32,27
2016/9/30,141097,港北区,仲手原二丁目,37,55,26,29
2016/9/30,141097,港北区,仲手原二丁目,38,46,23,23
2016/9/30,141097,港北区,仲手原二丁目,39,63,32,31
2016/9/30,141097,港北区,仲手原二丁目,40,57,26,31
2016/9/30,141097,港北区,仲手原二丁目,41,49,32,17
2016/9/30,141097,港北区,仲手原二丁目,42,49,26,23
2016/9/30,141097,港北区,仲手原二丁目,43,63,30,33
2016/9/30,141097,港北区,仲手原二丁目,44,49,24,25
2016/9/30,141097,港北区,仲手原二丁目,45,52,30,22
2016/9/30,141097,港北区,仲手原二丁目,46,59,36,23
2016/9/30,141097,港北区,仲手原二丁目,47,50,25,25
2016/9/30,141097,港北区,仲手原二丁目,48,48,28,20
2016/9/30,141097,港北区,仲手原二丁目,49,65,31,34
2016/9/30,141097,港北区,仲手原二丁目,50,57,23,34
2016/9/30,141097,港北区,仲手原二丁目,51,41,23,18
2016/9/30,141097,港北区,仲手原二丁目,52,52,27,25
2016/9/30,141097,港北区,仲手原二丁目,53,36,16,20
2016/9/30,141097,港北区,仲手原二丁目,54,44,19,25
2016/9/30,141097,港北区,仲手原二丁目,55,33,12,21
2016/9/30,141097,港北区,仲手原二丁目,56,37,17,20
2016/9/30,141097,港北区,仲手原二丁目,57,29,16,13
2016/9/30,141097,港北区,仲手原二丁目,58,29,15,14
2016/9/30,141097,港北区,仲手原二丁目,59,32,17,15
2016/9/30,141097,港北区,仲手原二丁目,60,34,16,18
2016/9/30,141097,港北区,仲手原二丁目,61,43,21,22
2016/9/30,141097,港北区,仲手原二丁目,62,39,21,18
2016/9/30,141097,港北区,仲手原二丁目,63,54,26,28
2016/9/30,141097,港北区,仲手原二丁目,64,28,16,12
2016/9/30,141097,港北区,仲手原二丁目,65,34,18,16
2016/9/30,141097,港北区,仲手原二丁目,66,37,14,23
2016/9/30,141097,港北区,仲手原二丁目,67,53,24,29
2016/9/30,141097,港北区,仲手原二丁目,68,48,25,23
2016/9/30,141097,港北区,仲手原二丁目,69,50,27,23
2016/9/30,141097,港北区,仲手原二丁目,70,27,15,12
2016/9/30,141097,港北区,仲手原二丁目,71,40,20,20
2016/9/30,141097,港北区,仲手原二丁目,72,29,9,20
2016/9/30,141097,港北区,仲手原二丁目,73,52,24,28
2016/9/30,141097,港北区,仲手原二丁目,74,31,15,16
2016/9/30,141097,港北区,仲手原二丁目,75,46,23,23
2016/9/30,141097,港北区,仲手原二丁目,76,36,15,21
2016/9/30,141097,港北区,仲手原二丁目,77,30,15,15
2016/9/30,141097,港北区,仲手原二丁目,78,27,13,14
2016/9/30,141097,港北区,仲手原二丁目,79,33,15,18
2016/9/30,141097,港北区,仲手原二丁目,80,27,11,16
2016/9/30,141097,港北区,仲手原二丁目,81,29,14,15
2016/9/30,141097,港北区,仲手原二丁目,82,17,6,11
2016/9/30,141097,港北区,仲手原二丁目,83,21,7,14
2016/9/30,141097,港北区,仲手原二丁目,84,24,10,14
2016/9/30,141097,港北区,仲手原二丁目,85,15,3,12
2016/9/30,141097,港北区,仲手原二丁目,86,25,6,19
2016/9/30,141097,港北区,仲手原二丁目,87,17,5,12
2016/9/30,141097,港北区,仲手原二丁目,88,20,9,11
2016/9/30,141097,港北区,仲手原二丁目,89,11,5,6
2016/9/30,141097,港北区,仲手原二丁目,90,13,5,8
2016/9/30,141097,港北区,仲手原二丁目,91,7,2,5
2016/9/30,141097,港北区,仲手原二丁目,92,9,1,8
2016/9/30,141097,港北区,仲手原二丁目,93,4,2,2
2016/9/30,141097,港北区,仲手原二丁目,94,3,3,0
2016/9/30,141097,港北区,仲手原二丁目,95,4,0,4
2016/9/30,141097,港北区,仲手原二丁目,96,4,1,3
2016/9/30,141097,港北区,仲手原二丁目,97,2,0,2
2016/9/30,141097,港北区,仲手原二丁目,98,3,0,3
2016/9/30,141097,港北区,仲手原二丁目,99,2,0,2
2016/9/30,141097,港北区,仲手原二丁目,100,3,1,2
2016/9/30,141097,港北区,篠原台町,合計,2748,1298,1450
2016/9/30,141097,港北区,篠原台町,0,17,8,9
2016/9/30,141097,港北区,篠原台町,1,23,11,12
2016/9/30,141097,港北区,篠原台町,2,16,7,9
2016/9/30,141097,港北区,篠原台町,3,17,9,8
2016/9/30,141097,港北区,篠原台町,4,20,7,13
2016/9/30,141097,港北区,篠原台町,5,23,14,9
2016/9/30,141097,港北区,篠原台町,6,22,11,11
2016/9/30,141097,港北区,篠原台町,7,19,4,15
2016/9/30,141097,港北区,篠原台町,8,27,18,9
2016/9/30,141097,港北区,篠原台町,9,23,13,10
2016/9/30,141097,港北区,篠原台町,10,31,19,12
2016/9/30,141097,港北区,篠原台町,11,21,12,9
2016/9/30,141097,港北区,篠原台町,12,24,13,11
2016/9/30,141097,港北区,篠原台町,13,20,9,11
2016/9/30,141097,港北区,篠原台町,14,26,10,16
2016/9/30,141097,港北区,篠原台町,15,27,14,13
2016/9/30,141097,港北区,篠原台町,16,16,7,9
2016/9/30,141097,港北区,篠原台町,17,20,7,13
2016/9/30,141097,港北区,篠原台町,18,27,15,12
2016/9/30,141097,港北区,篠原台町,19,20,6,14
2016/9/30,141097,港北区,篠原台町,20,29,11,18
2016/9/30,141097,港北区,篠原台町,21,33,14,19
2016/9/30,141097,港北区,篠原台町,22,39,20,19
2016/9/30,141097,港北区,篠原台町,23,27,17,10
2016/9/30,141097,港北区,篠原台町,24,31,12,19
2016/9/30,141097,港北区,篠原台町,25,34,17,17
2016/9/30,141097,港北区,篠原台町,26,46,19,27
2016/9/30,141097,港北区,篠原台町,27,32,8,24
2016/9/30,141097,港北区,篠原台町,28,32,16,16
2016/9/30,141097,港北区,篠原台町,29,28,11,17
2016/9/30,141097,港北区,篠原台町,30,33,23,10
2016/9/30,141097,港北区,篠原台町,31,37,16,21
2016/9/30,141097,港北区,篠原台町,32,35,21,14
2016/9/30,141097,港北区,篠原台町,33,21,9,12
2016/9/30,141097,港北区,篠原台町,34,34,15,19
2016/9/30,141097,港北区,篠原台町,35,31,17,14
2016/9/30,141097,港北区,篠原台町,36,31,13,18
2016/9/30,141097,港北区,篠原台町,37,26,9,17
2016/9/30,141097,港北区,篠原台町,38,40,17,23
2016/9/30,141097,港北区,篠原台町,39,42,22,20
2016/9/30,141097,港北区,篠原台町,40,44,18,26
2016/9/30,141097,港北区,篠原台町,41,32,17,15
2016/9/30,141097,港北区,篠原台町,42,47,25,22
2016/9/30,141097,港北区,篠原台町,43,53,29,24
2016/9/30,141097,港北区,篠原台町,44,46,23,23
2016/9/30,141097,港北区,篠原台町,45,44,17,27
2016/9/30,141097,港北区,篠原台町,46,52,25,27
2016/9/30,141097,港北区,篠原台町,47,37,19,18
2016/9/30,141097,港北区,篠原台町,48,57,26,31
2016/9/30,141097,港北区,篠原台町,49,45,28,17
2016/9/30,141097,港北区,篠原台町,50,21,10,11
2016/9/30,141097,港北区,篠原台町,51,55,28,27
2016/9/30,141097,港北区,篠原台町,52,42,19,23
2016/9/30,141097,港北区,篠原台町,53,41,17,24
2016/9/30,141097,港北区,篠原台町,54,30,15,15
2016/9/30,141097,港北区,篠原台町,55,40,19,21
2016/9/30,141097,港北区,篠原台町,56,29,14,15
2016/9/30,141097,港北区,篠原台町,57,23,13,10
2016/9/30,141097,港北区,篠原台町,58,30,17,13
2016/9/30,141097,港北区,篠原台町,59,36,18,18
2016/9/30,141097,港北区,篠原台町,60,41,24,17
2016/9/30,141097,港北区,篠原台町,61,30,13,17
2016/9/30,141097,港北区,篠原台町,62,29,17,12
2016/9/30,141097,港北区,篠原台町,63,30,13,17
2016/9/30,141097,港北区,篠原台町,64,35,20,15
2016/9/30,141097,港北区,篠原台町,65,36,22,14
2016/9/30,141097,港北区,篠原台町,66,41,26,15
2016/9/30,141097,港北区,篠原台町,67,46,20,26
2016/9/30,141097,港北区,篠原台町,68,39,19,20
2016/9/30,141097,港北区,篠原台町,69,38,14,24
2016/9/30,141097,港北区,篠原台町,70,26,11,15
2016/9/30,141097,港北区,篠原台町,71,20,9,11
2016/9/30,141097,港北区,篠原台町,72,25,13,12
2016/9/30,141097,港北区,篠原台町,73,38,19,19
2016/9/30,141097,港北区,篠原台町,74,28,17,11
2016/9/30,141097,港北区,篠原台町,75,25,9,16
2016/9/30,141097,港北区,篠原台町,76,26,12,14
2016/9/30,141097,港北区,篠原台町,77,33,12,21
2016/9/30,141097,港北区,篠原台町,78,19,8,11
2016/9/30,141097,港北区,篠原台町,79,28,9,19
2016/9/30,141097,港北区,篠原台町,80,20,10,10
2016/9/30,141097,港北区,篠原台町,81,27,9,18
2016/9/30,141097,港北区,篠原台町,82,25,6,19
2016/9/30,141097,港北区,篠原台町,83,13,4,9
2016/9/30,141097,港北区,篠原台町,84,18,8,10
2016/9/30,141097,港北区,篠原台町,85,15,3,12
2016/9/30,141097,港北区,篠原台町,86,9,3,6
2016/9/30,141097,港北区,篠原台町,87,15,6,9
2016/9/30,141097,港北区,篠原台町,88,13,3,10
2016/9/30,141097,港北区,篠原台町,89,8,3,5
2016/9/30,141097,港北区,篠原台町,90,9,5,4
2016/9/30,141097,港北区,篠原台町,91,5,1,4
2016/9/30,141097,港北区,篠原台町,92,6,3,3
2016/9/30,141097,港北区,篠原台町,93,3,1,2
2016/9/30,141097,港北区,篠原台町,94,7,3,4
2016/9/30,141097,港北区,篠原台町,95,3,2,1
2016/9/30,141097,港北区,篠原台町,96,3,2,1
2016/9/30,141097,港北区,篠原台町,97,3,0,3
2016/9/30,141097,港北区,篠原台町,98,2,1,1
2016/9/30,141097,港北区,篠原台町,99,1,0,1
2016/9/30,141097,港北区,篠原台町,100,6,0,6
2016/9/30,141097,港北区,篠原西町,合計,3296,1598,1698
2016/9/30,141097,港北区,篠原西町,0,29,16,13
2016/9/30,141097,港北区,篠原西町,1,27,11,16
2016/9/30,141097,港北区,篠原西町,2,23,12,11
2016/9/30,141097,港北区,篠原西町,3,21,7,14
2016/9/30,141097,港北区,篠原西町,4,22,16,6
2016/9/30,141097,港北区,篠原西町,5,29,16,13
2016/9/30,141097,港北区,篠原西町,6,18,11,7
2016/9/30,141097,港北区,篠原西町,7,25,9,16
2016/9/30,141097,港北区,篠原西町,8,28,16,12
2016/9/30,141097,港北区,篠原西町,9,22,9,13
2016/9/30,141097,港北区,篠原西町,10,23,13,10
2016/9/30,141097,港北区,篠原西町,11,27,17,10
2016/9/30,141097,港北区,篠原西町,12,19,13,6
2016/9/30,141097,港北区,篠原西町,13,38,15,23
2016/9/30,141097,港北区,篠原西町,14,22,12,10
2016/9/30,141097,港北区,篠原西町,15,23,13,10
2016/9/30,141097,港北区,篠原西町,16,25,7,18
2016/9/30,141097,港北区,篠原西町,17,16,6,10
2016/9/30,141097,港北区,篠原西町,18,38,14,24
2016/9/30,141097,港北区,篠原西町,19,33,14,19
2016/9/30,141097,港北区,篠原西町,20,35,15,20
2016/9/30,141097,港北区,篠原西町,21,35,20,15
2016/9/30,141097,港北区,篠原西町,22,34,14,20
2016/9/30,141097,港北区,篠原西町,23,31,16,15
2016/9/30,141097,港北区,篠原西町,24,44,20,24
2016/9/30,141097,港北区,篠原西町,25,43,32,11
2016/9/30,141097,港北区,篠原西町,26,50,21,29
2016/9/30,141097,港北区,篠原西町,27,38,15,23
2016/9/30,141097,港北区,篠原西町,28,47,28,19
2016/9/30,141097,港北区,篠原西町,29,44,20,24
2016/9/30,141097,港北区,篠原西町,30,50,22,28
2016/9/30,141097,港北区,篠原西町,31,53,23,30
2016/9/30,141097,港北区,篠原西町,32,52,25,27
2016/9/30,141097,港北区,篠原西町,33,53,29,24
2016/9/30,141097,港北区,篠原西町,34,48,26,22
2016/9/30,141097,港北区,篠原西町,35,46,21,25
2016/9/30,141097,港北区,篠原西町,36,55,29,26
2016/9/30,141097,港北区,篠原西町,37,46,22,24
2016/9/30,141097,港北区,篠原西町,38,46,25,21
2016/9/30,141097,港北区,篠原西町,39,44,28,16
2016/9/30,141097,港北区,篠原西町,40,43,23,20
2016/9/30,141097,港北区,篠原西町,41,42,21,21
2016/9/30,141097,港北区,篠原西町,42,51,29,22
2016/9/30,141097,港北区,篠原西町,43,49,22,27
2016/9/30,141097,港北区,篠原西町,44,57,30,27
2016/9/30,141097,港北区,篠原西町,45,59,36,23
2016/9/30,141097,港北区,篠原西町,46,55,22,33
2016/9/30,141097,港北区,篠原西町,47,51,24,27
2016/9/30,141097,港北区,篠原西町,48,47,27,20
2016/9/30,141097,港北区,篠原西町,49,46,20,26
2016/9/30,141097,港北区,篠原西町,50,46,21,25
2016/9/30,141097,港北区,篠原西町,51,53,27,26
2016/9/30,141097,港北区,篠原西町,52,39,20,19
2016/9/30,141097,港北区,篠原西町,53,40,18,22
2016/9/30,141097,港北区,篠原西町,54,49,24,25
2016/9/30,141097,港北区,篠原西町,55,38,20,18
2016/9/30,141097,港北区,篠原西町,56,50,22,28
2016/9/30,141097,港北区,篠原西町,57,37,16,21
2016/9/30,141097,港北区,篠原西町,58,33,17,16
2016/9/30,141097,港北区,篠原西町,59,40,15,25
2016/9/30,141097,港北区,篠原西町,60,37,21,16
2016/9/30,141097,港北区,篠原西町,61,37,18,19
2016/9/30,141097,港北区,篠原西町,62,37,15,22
2016/9/30,141097,港北区,篠原西町,63,35,20,15
2016/9/30,141097,港北区,篠原西町,64,24,16,8
2016/9/30,141097,港北区,篠原西町,65,40,20,20
2016/9/30,141097,港北区,篠原西町,66,38,20,18
2016/9/30,141097,港北区,篠原西町,67,46,26,20
2016/9/30,141097,港北区,篠原西町,68,52,22,30
2016/9/30,141097,港北区,篠原西町,69,42,15,27
2016/9/30,141097,港北区,篠原西町,70,37,22,15
2016/9/30,141097,港北区,篠原西町,71,34,13,21
2016/9/30,141097,港北区,篠原西町,72,33,18,15
2016/9/30,141097,港北区,篠原西町,73,33,10,23
2016/9/30,141097,港北区,篠原西町,74,28,19,9
2016/9/30,141097,港北区,篠原西町,75,42,14,28
2016/9/30,141097,港北区,篠原西町,76,26,9,17
2016/9/30,141097,港北区,篠原西町,77,27,16,11
2016/9/30,141097,港北区,篠原西町,78,29,16,13
2016/9/30,141097,港北区,篠原西町,79,22,7,15
2016/9/30,141097,港北区,篠原西町,80,32,11,21
2016/9/30,141097,港北区,篠原西町,81,25,14,11
2016/9/30,141097,港北区,篠原西町,82,21,12,9
2016/9/30,141097,港北区,篠原西町,83,22,8,14
2016/9/30,141097,港北区,篠原西町,84,29,9,20
2016/9/30,141097,港北区,篠原西町,85,32,13,19
2016/9/30,141097,港北区,篠原西町,86,17,9,8
2016/9/30,141097,港北区,篠原西町,87,13,8,5
2016/9/30,141097,港北区,篠原西町,88,10,5,5
2016/9/30,141097,港北区,篠原西町,89,12,4,8
2016/9/30,141097,港北区,篠原西町,90,12,5,7
2016/9/30,141097,港北区,篠原西町,91,11,5,6
2016/9/30,141097,港北区,篠原西町,92,4,0,4
2016/9/30,141097,港北区,篠原西町,93,8,2,6
2016/9/30,141097,港北区,篠原西町,94,7,1,6
2016/9/30,141097,港北区,篠原西町,95,3,0,3
2016/9/30,141097,港北区,篠原西町,96,3,2,1
2016/9/30,141097,港北区,篠原西町,97,3,0,3
2016/9/30,141097,港北区,篠原西町,98,3,0,3
2016/9/30,141097,港北区,篠原西町,99,1,0,1
2016/9/30,141097,港北区,篠原西町,100,2,1,1
2016/9/30,141097,港北区,新横浜一丁目,合計,6736,3609,3127
2016/9/30,141097,港北区,新横浜一丁目,0,79,43,36
2016/9/30,141097,港北区,新横浜一丁目,1,74,34,40
2016/9/30,141097,港北区,新横浜一丁目,2,70,36,34
2016/9/30,141097,港北区,新横浜一丁目,3,67,36,31
2016/9/30,141097,港北区,新横浜一丁目,4,49,32,17
2016/9/30,141097,港北区,新横浜一丁目,5,58,32,26
2016/9/30,141097,港北区,新横浜一丁目,6,54,27,27
2016/9/30,141097,港北区,新横浜一丁目,7,52,30,22
2016/9/30,141097,港北区,新横浜一丁目,8,52,32,20
2016/9/30,141097,港北区,新横浜一丁目,9,52,27,25
2016/9/30,141097,港北区,新横浜一丁目,10,33,16,17
2016/9/30,141097,港北区,新横浜一丁目,11,46,29,17
2016/9/30,141097,港北区,新横浜一丁目,12,46,21,25
2016/9/30,141097,港北区,新横浜一丁目,13,35,20,15
2016/9/30,141097,港北区,新横浜一丁目,14,47,20,27
2016/9/30,141097,港北区,新横浜一丁目,15,49,20,29
2016/9/30,141097,港北区,新横浜一丁目,16,50,28,22
2016/9/30,141097,港北区,新横浜一丁目,17,57,24,33
2016/9/30,141097,港北区,新横浜一丁目,18,36,17,19
2016/9/30,141097,港北区,新横浜一丁目,19,43,22,21
2016/9/30,141097,港北区,新横浜一丁目,20,50,24,26
2016/9/30,141097,港北区,新横浜一丁目,21,49,17,32
2016/9/30,141097,港北区,新横浜一丁目,22,59,31,28
2016/9/30,141097,港北区,新横浜一丁目,23,72,37,35
2016/9/30,141097,港北区,新横浜一丁目,24,93,55,38
2016/9/30,141097,港北区,新横浜一丁目,25,101,57,44
2016/9/30,141097,港北区,新横浜一丁目,26,90,53,37
2016/9/30,141097,港北区,新横浜一丁目,27,115,56,59
2016/9/30,141097,港北区,新横浜一丁目,28,105,58,47
2016/9/30,141097,港北区,新横浜一丁目,29,126,62,64
2016/9/30,141097,港北区,新横浜一丁目,30,121,66,55
2016/9/30,141097,港北区,新横浜一丁目,31,145,72,73
2016/9/30,141097,港北区,新横浜一丁目,32,126,69,57
2016/9/30,141097,港北区,新横浜一丁目,33,118,68,50
2016/9/30,141097,港北区,新横浜一丁目,34,159,79,80
2016/9/30,141097,港北区,新横浜一丁目,35,127,62,65
2016/9/30,141097,港北区,新横浜一丁目,36,145,78,67
2016/9/30,141097,港北区,新横浜一丁目,37,158,90,68
2016/9/30,141097,港北区,新横浜一丁目,38,158,83,75
2016/9/30,141097,港北区,新横浜一丁目,39,140,76,64
2016/9/30,141097,港北区,新横浜一丁目,40,153,87,66
2016/9/30,141097,港北区,新横浜一丁目,41,154,81,73
2016/9/30,141097,港北区,新横浜一丁目,42,154,96,58
2016/9/30,141097,港北区,新横浜一丁目,43,156,87,69
2016/9/30,141097,港北区,新横浜一丁目,44,165,91,74
2016/9/30,141097,港北区,新横浜一丁目,45,147,69,78
2016/9/30,141097,港北区,新横浜一丁目,46,157,87,70
2016/9/30,141097,港北区,新横浜一丁目,47,166,94,72
2016/9/30,141097,港北区,新横浜一丁目,48,136,84,52
2016/9/30,141097,港北区,新横浜一丁目,49,117,68,49
2016/9/30,141097,港北区,新横浜一丁目,50,117,72,45
2016/9/30,141097,港北区,新横浜一丁目,51,111,61,50
2016/9/30,141097,港北区,新横浜一丁目,52,99,56,43
2016/9/30,141097,港北区,新横浜一丁目,53,113,68,45
2016/9/30,141097,港北区,新横浜一丁目,54,114,69,45
2016/9/30,141097,港北区,新横浜一丁目,55,80,46,34
2016/9/30,141097,港北区,新横浜一丁目,56,59,32,27
2016/9/30,141097,港北区,新横浜一丁目,57,65,40,25
2016/9/30,141097,港北区,新横浜一丁目,58,51,25,26
2016/9/30,141097,港北区,新横浜一丁目,59,58,29,29
2016/9/30,141097,港北区,新横浜一丁目,60,53,36,17
2016/9/30,141097,港北区,新横浜一丁目,61,68,46,22
2016/9/30,141097,港北区,新横浜一丁目,62,59,35,24
2016/9/30,141097,港北区,新横浜一丁目,63,56,30,26
2016/9/30,141097,港北区,新横浜一丁目,64,45,31,14
2016/9/30,141097,港北区,新横浜一丁目,65,57,35,22
2016/9/30,141097,港北区,新横浜一丁目,66,61,38,23
2016/9/30,141097,港北区,新横浜一丁目,67,64,34,30
2016/9/30,141097,港北区,新横浜一丁目,68,46,23,23
2016/9/30,141097,港北区,新横浜一丁目,69,47,25,22
2016/9/30,141097,港北区,新横浜一丁目,70,29,14,15
2016/9/30,141097,港北区,新横浜一丁目,71,33,15,18
2016/9/30,141097,港北区,新横浜一丁目,72,30,12,18
2016/9/30,141097,港北区,新横浜一丁目,73,31,19,12
2016/9/30,141097,港北区,新横浜一丁目,74,37,16,21
2016/9/30,141097,港北区,新横浜一丁目,75,38,17,21
2016/9/30,141097,港北区,新横浜一丁目,76,35,15,20
2016/9/30,141097,港北区,新横浜一丁目,77,21,9,12
2016/9/30,141097,港北区,新横浜一丁目,78,33,14,19
2016/9/30,141097,港北区,新横浜一丁目,79,18,5,13
2016/9/30,141097,港北区,新横浜一丁目,80,28,7,21
2016/9/30,141097,港北区,新横浜一丁目,81,18,10,8
2016/9/30,141097,港北区,新横浜一丁目,82,28,9,19
2016/9/30,141097,港北区,新横浜一丁目,83,19,6,13
2016/9/30,141097,港北区,新横浜一丁目,84,12,3,9
2016/9/30,141097,港北区,新横浜一丁目,85,14,3,11
2016/9/30,141097,港北区,新横浜一丁目,86,15,4,11
2016/9/30,141097,港北区,新横浜一丁目,87,11,3,8
2016/9/30,141097,港北区,新横浜一丁目,88,8,3,5
2016/9/30,141097,港北区,新横浜一丁目,89,9,2,7
2016/9/30,141097,港北区,新横浜一丁目,90,6,1,5
2016/9/30,141097,港北区,新横浜一丁目,91,7,4,3
2016/9/30,141097,港北区,新横浜一丁目,92,3,1,2
2016/9/30,141097,港北区,新横浜一丁目,93,5,2,3
2016/9/30,141097,港北区,新横浜一丁目,94,4,1,3
2016/9/30,141097,港北区,新横浜一丁目,95,1,0,1
2016/9/30,141097,港北区,新横浜一丁目,96,2,0,2
2016/9/30,141097,港北区,新横浜一丁目,97,2,0,2
2016/9/30,141097,港北区,新横浜一丁目,98,1,0,1
2016/9/30,141097,港北区,新横浜一丁目,99,0,0,0
2016/9/30,141097,港北区,新横浜一丁目,100,4,0,4
2016/9/30,141097,港北区,新横浜二丁目,合計,2026,1062,964
2016/9/30,141097,港北区,新横浜二丁目,0,26,12,14
2016/9/30,141097,港北区,新横浜二丁目,1,23,11,12
2016/9/30,141097,港北区,新横浜二丁目,2,13,7,6
2016/9/30,141097,港北区,新横浜二丁目,3,15,8,7
2016/9/30,141097,港北区,新横浜二丁目,4,11,4,7
2016/9/30,141097,港北区,新横浜二丁目,5,16,6,10
2016/9/30,141097,港北区,新横浜二丁目,6,10,5,5
2016/9/30,141097,港北区,新横浜二丁目,7,9,4,5
2016/9/30,141097,港北区,新横浜二丁目,8,7,1,6
2016/9/30,141097,港北区,新横浜二丁目,9,10,3,7
2016/9/30,141097,港北区,新横浜二丁目,10,16,10,6
2016/9/30,141097,港北区,新横浜二丁目,11,6,3,3
2016/9/30,141097,港北区,新横浜二丁目,12,18,13,5
2016/9/30,141097,港北区,新横浜二丁目,13,9,2,7
2016/9/30,141097,港北区,新横浜二丁目,14,8,5,3
2016/9/30,141097,港北区,新横浜二丁目,15,14,8,6
2016/9/30,141097,港北区,新横浜二丁目,16,11,6,5
2016/9/30,141097,港北区,新横浜二丁目,17,11,7,4
2016/9/30,141097,港北区,新横浜二丁目,18,15,5,10
2016/9/30,141097,港北区,新横浜二丁目,19,22,9,13
2016/9/30,141097,港北区,新横浜二丁目,20,17,9,8
2016/9/30,141097,港北区,新横浜二丁目,21,11,5,6
2016/9/30,141097,港北区,新横浜二丁目,22,14,6,8
2016/9/30,141097,港北区,新横浜二丁目,23,24,10,14
2016/9/30,141097,港北区,新横浜二丁目,24,26,13,13
2016/9/30,141097,港北区,新横浜二丁目,25,26,19,7
2016/9/30,141097,港北区,新横浜二丁目,26,27,13,14
2016/9/30,141097,港北区,新横浜二丁目,27,28,17,11
2016/9/30,141097,港北区,新横浜二丁目,28,37,20,17
2016/9/30,141097,港北区,新横浜二丁目,29,41,19,22
2016/9/30,141097,港北区,新横浜二丁目,30,52,27,25
2016/9/30,141097,港北区,新横浜二丁目,31,58,32,26
2016/9/30,141097,港北区,新横浜二丁目,32,34,19,15
2016/9/30,141097,港北区,新横浜二丁目,33,47,21,26
2016/9/30,141097,港北区,新横浜二丁目,34,34,18,16
2016/9/30,141097,港北区,新横浜二丁目,35,41,22,19
2016/9/30,141097,港北区,新横浜二丁目,36,41,29,12
2016/9/30,141097,港北区,新横浜二丁目,37,46,25,21
2016/9/30,141097,港北区,新横浜二丁目,38,39,25,14
2016/9/30,141097,港北区,新横浜二丁目,39,42,23,19
2016/9/30,141097,港北区,新横浜二丁目,40,47,22,25
2016/9/30,141097,港北区,新横浜二丁目,41,48,22,26
2016/9/30,141097,港北区,新横浜二丁目,42,54,30,24
2016/9/30,141097,港北区,新横浜二丁目,43,39,24,15
2016/9/30,141097,港北区,新横浜二丁目,44,42,24,18
2016/9/30,141097,港北区,新横浜二丁目,45,47,23,24
2016/9/30,141097,港北区,新横浜二丁目,46,39,24,15
2016/9/30,141097,港北区,新横浜二丁目,47,39,17,22
2016/9/30,141097,港北区,新横浜二丁目,48,31,14,17
2016/9/30,141097,港北区,新横浜二丁目,49,52,28,24
2016/9/30,141097,港北区,新横浜二丁目,50,41,22,19
2016/9/30,141097,港北区,新横浜二丁目,51,46,30,16
2016/9/30,141097,港北区,新横浜二丁目,52,50,25,25
2016/9/30,141097,港北区,新横浜二丁目,53,43,21,22
2016/9/30,141097,港北区,新横浜二丁目,54,29,17,12
2016/9/30,141097,港北区,新横浜二丁目,55,27,16,11
2016/9/30,141097,港北区,新横浜二丁目,56,35,20,15
2016/9/30,141097,港北区,新横浜二丁目,57,22,10,12
2016/9/30,141097,港北区,新横浜二丁目,58,29,23,6
2016/9/30,141097,港北区,新横浜二丁目,59,29,14,15
2016/9/30,141097,港北区,新横浜二丁目,60,16,7,9
2016/9/30,141097,港北区,新横浜二丁目,61,18,12,6
2016/9/30,141097,港北区,新横浜二丁目,62,14,11,3
2016/9/30,141097,港北区,新横浜二丁目,63,10,4,6
2016/9/30,141097,港北区,新横浜二丁目,64,12,5,7
2016/9/30,141097,港北区,新横浜二丁目,65,16,6,10
2016/9/30,141097,港北区,新横浜二丁目,66,14,7,7
2016/9/30,141097,港北区,新横浜二丁目,67,18,10,8
2016/9/30,141097,港北区,新横浜二丁目,68,18,10,8
2016/9/30,141097,港北区,新横浜二丁目,69,15,7,8
2016/9/30,141097,港北区,新横浜二丁目,70,13,8,5
2016/9/30,141097,港北区,新横浜二丁目,71,14,8,6
2016/9/30,141097,港北区,新横浜二丁目,72,6,4,2
2016/9/30,141097,港北区,新横浜二丁目,73,11,7,4
2016/9/30,141097,港北区,新横浜二丁目,74,10,2,8
2016/9/30,141097,港北区,新横浜二丁目,75,10,3,7
2016/9/30,141097,港北区,新横浜二丁目,76,9,5,4
2016/9/30,141097,港北区,新横浜二丁目,77,1,0,1
2016/9/30,141097,港北区,新横浜二丁目,78,6,2,4
2016/9/30,141097,港北区,新横浜二丁目,79,7,3,4
2016/9/30,141097,港北区,新横浜二丁目,80,4,2,2
2016/9/30,141097,港北区,新横浜二丁目,81,8,5,3
2016/9/30,141097,港北区,新横浜二丁目,82,4,0,4
2016/9/30,141097,港北区,新横浜二丁目,83,4,2,2
2016/9/30,141097,港北区,新横浜二丁目,84,4,0,4
2016/9/30,141097,港北区,新横浜二丁目,85,5,0,5
2016/9/30,141097,港北区,新横浜二丁目,86,5,1,4
2016/9/30,141097,港北区,新横浜二丁目,87,0,0,0
2016/9/30,141097,港北区,新横浜二丁目,88,2,2,0
2016/9/30,141097,港北区,新横浜二丁目,89,1,0,1
2016/9/30,141097,港北区,新横浜二丁目,90,2,1,1
2016/9/30,141097,港北区,新横浜二丁目,91,3,1,2
2016/9/30,141097,港北区,新横浜二丁目,92,0,0,0
2016/9/30,141097,港北区,新横浜二丁目,93,1,0,1
2016/9/30,141097,港北区,新横浜二丁目,94,0,0,0
2016/9/30,141097,港北区,新横浜二丁目,95,0,0,0
2016/9/30,141097,港北区,新横浜二丁目,96,0,0,0
2016/9/30,141097,港北区,新横浜二丁目,97,1,0,1
2016/9/30,141097,港北区,新横浜二丁目,98,0,0,0
2016/9/30,141097,港北区,新横浜二丁目,99,0,0,0
2016/9/30,141097,港北区,新横浜二丁目,100,0,0,0
2016/9/30,141097,港北区,新横浜三丁目,合計,2289,1163,1126
2016/9/30,141097,港北区,新横浜三丁目,0,21,10,11
2016/9/30,141097,港北区,新横浜三丁目,1,21,7,14
2016/9/30,141097,港北区,新横浜三丁目,2,23,15,8
2016/9/30,141097,港北区,新横浜三丁目,3,15,9,6
2016/9/30,141097,港北区,新横浜三丁目,4,11,4,7
2016/9/30,141097,港北区,新横浜三丁目,5,14,7,7
2016/9/30,141097,港北区,新横浜三丁目,6,10,6,4
2016/9/30,141097,港北区,新横浜三丁目,7,6,2,4
2016/9/30,141097,港北区,新横浜三丁目,8,12,7,5
2016/9/30,141097,港北区,新横浜三丁目,9,4,2,2
2016/9/30,141097,港北区,新横浜三丁目,10,20,10,10
2016/9/30,141097,港北区,新横浜三丁目,11,4,2,2
2016/9/30,141097,港北区,新横浜三丁目,12,11,4,7
2016/9/30,141097,港北区,新横浜三丁目,13,15,10,5
2016/9/30,141097,港北区,新横浜三丁目,14,16,6,10
2016/9/30,141097,港北区,新横浜三丁目,15,8,2,6
2016/9/30,141097,港北区,新横浜三丁目,16,12,6,6
2016/9/30,141097,港北区,新横浜三丁目,17,9,6,3
2016/9/30,141097,港北区,新横浜三丁目,18,12,7,5
2016/9/30,141097,港北区,新横浜三丁目,19,9,3,6
2016/9/30,141097,港北区,新横浜三丁目,20,20,11,9
2016/9/30,141097,港北区,新横浜三丁目,21,20,9,11
2016/9/30,141097,港北区,新横浜三丁目,22,33,12,21
2016/9/30,141097,港北区,新横浜三丁目,23,38,20,18
2016/9/30,141097,港北区,新横浜三丁目,24,46,22,24
2016/9/30,141097,港北区,新横浜三丁目,25,50,26,24
2016/9/30,141097,港北区,新横浜三丁目,26,51,23,28
2016/9/30,141097,港北区,新横浜三丁目,27,55,30,25
2016/9/30,141097,港北区,新横浜三丁目,28,60,32,28
2016/9/30,141097,港北区,新横浜三丁目,29,49,21,28
2016/9/30,141097,港北区,新横浜三丁目,30,57,32,25
2016/9/30,141097,港北区,新横浜三丁目,31,50,25,25
2016/9/30,141097,港北区,新横浜三丁目,32,52,30,22
2016/9/30,141097,港北区,新横浜三丁目,33,49,25,24
2016/9/30,141097,港北区,新横浜三丁目,34,49,20,29
2016/9/30,141097,港北区,新横浜三丁目,35,56,35,21
2016/9/30,141097,港北区,新横浜三丁目,36,51,26,25
2016/9/30,141097,港北区,新横浜三丁目,37,51,26,25
2016/9/30,141097,港北区,新横浜三丁目,38,41,22,19
2016/9/30,141097,港北区,新横浜三丁目,39,39,18,21
2016/9/30,141097,港北区,新横浜三丁目,40,54,31,23
2016/9/30,141097,港北区,新横浜三丁目,41,51,27,24
2016/9/30,141097,港北区,新横浜三丁目,42,43,21,22
2016/9/30,141097,港北区,新横浜三丁目,43,44,22,22
2016/9/30,141097,港北区,新横浜三丁目,44,61,33,28
2016/9/30,141097,港北区,新横浜三丁目,45,43,20,23
2016/9/30,141097,港北区,新横浜三丁目,46,47,23,24
2016/9/30,141097,港北区,新横浜三丁目,47,36,14,22
2016/9/30,141097,港北区,新横浜三丁目,48,52,28,24
2016/9/30,141097,港北区,新横浜三丁目,49,43,22,21
2016/9/30,141097,港北区,新横浜三丁目,50,46,27,19
2016/9/30,141097,港北区,新横浜三丁目,51,49,25,24
2016/9/30,141097,港北区,新横浜三丁目,52,49,23,26
2016/9/30,141097,港北区,新横浜三丁目,53,35,23,12
2016/9/30,141097,港北区,新横浜三丁目,54,45,24,21
2016/9/30,141097,港北区,新横浜三丁目,55,17,9,8
2016/9/30,141097,港北区,新横浜三丁目,56,25,11,14
2016/9/30,141097,港北区,新横浜三丁目,57,26,16,10
2016/9/30,141097,港北区,新横浜三丁目,58,22,15,7
2016/9/30,141097,港北区,新横浜三丁目,59,18,10,8
2016/9/30,141097,港北区,新横浜三丁目,60,23,12,11
2016/9/30,141097,港北区,新横浜三丁目,61,24,14,10
2016/9/30,141097,港北区,新横浜三丁目,62,14,6,8
2016/9/30,141097,港北区,新横浜三丁目,63,23,12,11
2016/9/30,141097,港北区,新横浜三丁目,64,19,10,9
2016/9/30,141097,港北区,新横浜三丁目,65,11,5,6
2016/9/30,141097,港北区,新横浜三丁目,66,21,6,15
2016/9/30,141097,港北区,新横浜三丁目,67,21,12,9
2016/9/30,141097,港北区,新横浜三丁目,68,19,8,11
2016/9/30,141097,港北区,新横浜三丁目,69,11,6,5
2016/9/30,141097,港北区,新横浜三丁目,70,15,9,6
2016/9/30,141097,港北区,新横浜三丁目,71,9,4,5
2016/9/30,141097,港北区,新横浜三丁目,72,6,2,4
2016/9/30,141097,港北区,新横浜三丁目,73,10,5,5
2016/9/30,141097,港北区,新横浜三丁目,74,10,5,5
2016/9/30,141097,港北区,新横浜三丁目,75,7,5,2
2016/9/30,141097,港北区,新横浜三丁目,76,7,1,6
2016/9/30,141097,港北区,新横浜三丁目,77,4,1,3
2016/9/30,141097,港北区,新横浜三丁目,78,7,3,4
2016/9/30,141097,港北区,新横浜三丁目,79,7,4,3
2016/9/30,141097,港北区,新横浜三丁目,80,8,4,4
2016/9/30,141097,港北区,新横浜三丁目,81,4,1,3
2016/9/30,141097,港北区,新横浜三丁目,82,2,0,2
2016/9/30,141097,港北区,新横浜三丁目,83,4,2,2
2016/9/30,141097,港北区,新横浜三丁目,84,7,6,1
2016/9/30,141097,港北区,新横浜三丁目,85,1,1,0
2016/9/30,141097,港北区,新横浜三丁目,86,4,1,3
2016/9/30,141097,港北区,新横浜三丁目,87,4,1,3
2016/9/30,141097,港北区,新横浜三丁目,88,4,0,4
2016/9/30,141097,港北区,新横浜三丁目,89,2,1,1
2016/9/30,141097,港北区,新横浜三丁目,90,2,1,1
2016/9/30,141097,港北区,新横浜三丁目,91,1,0,1
2016/9/30,141097,港北区,新横浜三丁目,92,0,0,0
2016/9/30,141097,港北区,新横浜三丁目,93,0,0,0
2016/9/30,141097,港北区,新横浜三丁目,94,0,0,0
2016/9/30,141097,港北区,新横浜三丁目,95,1,0,1
2016/9/30,141097,港北区,新横浜三丁目,96,0,0,0
2016/9/30,141097,港北区,新横浜三丁目,97,1,1,0
2016/9/30,141097,港北区,新横浜三丁目,98,0,0,0
2016/9/30,141097,港北区,新横浜三丁目,99,0,0,0
2016/9/30,141097,港北区,新横浜三丁目,100,0,0,0
2016/9/30,141097,港北区,高田東一丁目,合計,2423,1228,1195
2016/9/30,141097,港北区,高田東一丁目,0,18,6,12
2016/9/30,141097,港北区,高田東一丁目,1,19,10,9
2016/9/30,141097,港北区,高田東一丁目,2,19,8,11
2016/9/30,141097,港北区,高田東一丁目,3,25,9,16
2016/9/30,141097,港北区,高田東一丁目,4,15,7,8
2016/9/30,141097,港北区,高田東一丁目,5,14,7,7
2016/9/30,141097,港北区,高田東一丁目,6,22,12,10
2016/9/30,141097,港北区,高田東一丁目,7,19,10,9
2016/9/30,141097,港北区,高田東一丁目,8,25,13,12
2016/9/30,141097,港北区,高田東一丁目,9,19,9,10
2016/9/30,141097,港北区,高田東一丁目,10,12,7,5
2016/9/30,141097,港北区,高田東一丁目,11,17,7,10
2016/9/30,141097,港北区,高田東一丁目,12,20,9,11
2016/9/30,141097,港北区,高田東一丁目,13,13,6,7
2016/9/30,141097,港北区,高田東一丁目,14,17,8,9
2016/9/30,141097,港北区,高田東一丁目,15,21,15,6
2016/9/30,141097,港北区,高田東一丁目,16,16,5,11
2016/9/30,141097,港北区,高田東一丁目,17,19,7,12
2016/9/30,141097,港北区,高田東一丁目,18,20,9,11
2016/9/30,141097,港北区,高田東一丁目,19,20,11,9
2016/9/30,141097,港北区,高田東一丁目,20,29,15,14
2016/9/30,141097,港北区,高田東一丁目,21,23,14,9
2016/9/30,141097,港北区,高田東一丁目,22,23,11,12
2016/9/30,141097,港北区,高田東一丁目,23,26,13,13
2016/9/30,141097,港北区,高田東一丁目,24,34,20,14
2016/9/30,141097,港北区,高田東一丁目,25,25,15,10
2016/9/30,141097,港北区,高田東一丁目,26,39,24,15
2016/9/30,141097,港北区,高田東一丁目,27,37,14,23
2016/9/30,141097,港北区,高田東一丁目,28,43,23,20
2016/9/30,141097,港北区,高田東一丁目,29,35,19,16
2016/9/30,141097,港北区,高田東一丁目,30,32,19,13
2016/9/30,141097,港北区,高田東一丁目,31,28,19,9
2016/9/30,141097,港北区,高田東一丁目,32,37,18,19
2016/9/30,141097,港北区,高田東一丁目,33,37,21,16
2016/9/30,141097,港北区,高田東一丁目,34,37,22,15
2016/9/30,141097,港北区,高田東一丁目,35,41,21,20
2016/9/30,141097,港北区,高田東一丁目,36,41,21,20
2016/9/30,141097,港北区,高田東一丁目,37,34,20,14
2016/9/30,141097,港北区,高田東一丁目,38,38,24,14
2016/9/30,141097,港北区,高田東一丁目,39,42,20,22
2016/9/30,141097,港北区,高田東一丁目,40,47,21,26
2016/9/30,141097,港北区,高田東一丁目,41,44,19,25
2016/9/30,141097,港北区,高田東一丁目,42,37,24,13
2016/9/30,141097,港北区,高田東一丁目,43,40,23,17
2016/9/30,141097,港北区,高田東一丁目,44,51,36,15
2016/9/30,141097,港北区,高田東一丁目,45,37,28,9
2016/9/30,141097,港北区,高田東一丁目,46,42,26,16
2016/9/30,141097,港北区,高田東一丁目,47,46,25,21
2016/9/30,141097,港北区,高田東一丁目,48,43,23,20
2016/9/30,141097,港北区,高田東一丁目,49,43,20,23
2016/9/30,141097,港北区,高田東一丁目,50,26,13,13
2016/9/30,141097,港北区,高田東一丁目,51,26,15,11
2016/9/30,141097,港北区,高田東一丁目,52,30,15,15
2016/9/30,141097,港北区,高田東一丁目,53,36,16,20
2016/9/30,141097,港北区,高田東一丁目,54,31,16,15
2016/9/30,141097,港北区,高田東一丁目,55,20,14,6
2016/9/30,141097,港北区,高田東一丁目,56,22,15,7
2016/9/30,141097,港北区,高田東一丁目,57,20,11,9
2016/9/30,141097,港北区,高田東一丁目,58,27,13,14
2016/9/30,141097,港北区,高田東一丁目,59,20,11,9
2016/9/30,141097,港北区,高田東一丁目,60,26,14,12
2016/9/30,141097,港北区,高田東一丁目,61,27,13,14
2016/9/30,141097,港北区,高田東一丁目,62,24,14,10
2016/9/30,141097,港北区,高田東一丁目,63,25,12,13
2016/9/30,141097,港北区,高田東一丁目,64,31,13,18
2016/9/30,141097,港北区,高田東一丁目,65,27,14,13
2016/9/30,141097,港北区,高田東一丁目,66,24,12,12
2016/9/30,141097,港北区,高田東一丁目,67,26,13,13
2016/9/30,141097,港北区,高田東一丁目,68,31,18,13
2016/9/30,141097,港北区,高田東一丁目,69,39,19,20
2016/9/30,141097,港北区,高田東一丁目,70,13,8,5
2016/9/30,141097,港北区,高田東一丁目,71,20,9,11
2016/9/30,141097,港北区,高田東一丁目,72,14,9,5
2016/9/30,141097,港北区,高田東一丁目,73,14,5,9
2016/9/30,141097,港北区,高田東一丁目,74,27,7,20
2016/9/30,141097,港北区,高田東一丁目,75,27,10,17
2016/9/30,141097,港北区,高田東一丁目,76,24,5,19
2016/9/30,141097,港北区,高田東一丁目,77,17,9,8
2016/9/30,141097,港北区,高田東一丁目,78,24,12,12
2016/9/30,141097,港北区,高田東一丁目,79,27,11,16
2016/9/30,141097,港北区,高田東一丁目,80,16,8,8
2016/9/30,141097,港北区,高田東一丁目,81,17,7,10
2016/9/30,141097,港北区,高田東一丁目,82,15,5,10
2016/9/30,141097,港北区,高田東一丁目,83,17,5,12
2016/9/30,141097,港北区,高田東一丁目,84,15,3,12
2016/9/30,141097,港北区,高田東一丁目,85,15,7,8
2016/9/30,141097,港北区,高田東一丁目,86,15,6,9
2016/9/30,141097,港北区,高田東一丁目,87,10,6,4
2016/9/30,141097,港北区,高田東一丁目,88,10,3,7
2016/9/30,141097,港北区,高田東一丁目,89,11,4,7
2016/9/30,141097,港北区,高田東一丁目,90,7,1,6
2016/9/30,141097,港北区,高田東一丁目,91,17,6,11
2016/9/30,141097,港北区,高田東一丁目,92,8,3,5
2016/9/30,141097,港北区,高田東一丁目,93,5,0,5
2016/9/30,141097,港北区,高田東一丁目,94,4,2,2
2016/9/30,141097,港北区,高田東一丁目,95,4,2,2
2016/9/30,141097,港北区,高田東一丁目,96,0,0,0
2016/9/30,141097,港北区,高田東一丁目,97,2,1,1
2016/9/30,141097,港北区,高田東一丁目,98,2,0,2
2016/9/30,141097,港北区,高田東一丁目,99,1,0,1
2016/9/30,141097,港北区,高田東一丁目,100,6,0,6
2016/9/30,141097,港北区,高田東二丁目,合計,1366,670,696
2016/9/30,141097,港北区,高田東二丁目,0,11,6,5
2016/9/30,141097,港北区,高田東二丁目,1,15,10,5
2016/9/30,141097,港北区,高田東二丁目,2,14,10,4
2016/9/30,141097,港北区,高田東二丁目,3,11,4,7
2016/9/30,141097,港北区,高田東二丁目,4,10,7,3
2016/9/30,141097,港北区,高田東二丁目,5,13,8,5
2016/9/30,141097,港北区,高田東二丁目,6,10,4,6
2016/9/30,141097,港北区,高田東二丁目,7,19,9,10
2016/9/30,141097,港北区,高田東二丁目,8,11,3,8
2016/9/30,141097,港北区,高田東二丁目,9,17,9,8
2016/9/30,141097,港北区,高田東二丁目,10,11,5,6
2016/9/30,141097,港北区,高田東二丁目,11,13,4,9
2016/9/30,141097,港北区,高田東二丁目,12,11,6,5
2016/9/30,141097,港北区,高田東二丁目,13,16,8,8
2016/9/30,141097,港北区,高田東二丁目,14,15,10,5
2016/9/30,141097,港北区,高田東二丁目,15,12,3,9
2016/9/30,141097,港北区,高田東二丁目,16,17,8,9
2016/9/30,141097,港北区,高田東二丁目,17,10,4,6
2016/9/30,141097,港北区,高田東二丁目,18,13,4,9
2016/9/30,141097,港北区,高田東二丁目,19,6,4,2
2016/9/30,141097,港北区,高田東二丁目,20,10,4,6
2016/9/30,141097,港北区,高田東二丁目,21,10,3,7
2016/9/30,141097,港北区,高田東二丁目,22,11,5,6
2016/9/30,141097,港北区,高田東二丁目,23,11,5,6
2016/9/30,141097,港北区,高田東二丁目,24,14,6,8
2016/9/30,141097,港北区,高田東二丁目,25,11,7,4
2016/9/30,141097,港北区,高田東二丁目,26,8,6,2
2016/9/30,141097,港北区,高田東二丁目,27,10,4,6
2016/9/30,141097,港北区,高田東二丁目,28,19,8,11
2016/9/30,141097,港北区,高田東二丁目,29,24,12,12
2016/9/30,141097,港北区,高田東二丁目,30,10,6,4
2016/9/30,141097,港北区,高田東二丁目,31,10,5,5
2016/9/30,141097,港北区,高田東二丁目,32,29,12,17
2016/9/30,141097,港北区,高田東二丁目,33,20,10,10
2016/9/30,141097,港北区,高田東二丁目,34,20,9,11
2016/9/30,141097,港北区,高田東二丁目,35,18,10,8
2016/9/30,141097,港北区,高田東二丁目,36,20,8,12
2016/9/30,141097,港北区,高田東二丁目,37,19,11,8
2016/9/30,141097,港北区,高田東二丁目,38,24,14,10
2016/9/30,141097,港北区,高田東二丁目,39,19,8,11
2016/9/30,141097,港北区,高田東二丁目,40,20,10,10
2016/9/30,141097,港北区,高田東二丁目,41,24,15,9
2016/9/30,141097,港北区,高田東二丁目,42,26,12,14
2016/9/30,141097,港北区,高田東二丁目,43,31,16,15
2016/9/30,141097,港北区,高田東二丁目,44,17,4,13
2016/9/30,141097,港北区,高田東二丁目,45,29,15,14
2016/9/30,141097,港北区,高田東二丁目,46,23,8,15
2016/9/30,141097,港北区,高田東二丁目,47,25,15,10
2016/9/30,141097,港北区,高田東二丁目,48,33,19,14
2016/9/30,141097,港北区,高田東二丁目,49,28,14,14
2016/9/30,141097,港北区,高田東二丁目,50,22,12,10
2016/9/30,141097,港北区,高田東二丁目,51,20,8,12
2016/9/30,141097,港北区,高田東二丁目,52,19,13,6
2016/9/30,141097,港北区,高田東二丁目,53,18,9,9
2016/9/30,141097,港北区,高田東二丁目,54,13,7,6
2016/9/30,141097,港北区,高田東二丁目,55,16,12,4
2016/9/30,141097,港北区,高田東二丁目,56,8,4,4
2016/9/30,141097,港北区,高田東二丁目,57,10,6,4
2016/9/30,141097,港北区,高田東二丁目,58,14,8,6
2016/9/30,141097,港北区,高田東二丁目,59,5,3,2
2016/9/30,141097,港北区,高田東二丁目,60,12,7,5
2016/9/30,141097,港北区,高田東二丁目,61,15,7,8
2016/9/30,141097,港北区,高田東二丁目,62,16,11,5
2016/9/30,141097,港北区,高田東二丁目,63,10,7,3
2016/9/30,141097,港北区,高田東二丁目,64,12,6,6
2016/9/30,141097,港北区,高田東二丁目,65,16,6,10
2016/9/30,141097,港北区,高田東二丁目,66,20,14,6
2016/9/30,141097,港北区,高田東二丁目,67,14,6,8
2016/9/30,141097,港北区,高田東二丁目,68,8,4,4
2016/9/30,141097,港北区,高田東二丁目,69,16,5,11
2016/9/30,141097,港北区,高田東二丁目,70,13,8,5
2016/9/30,141097,港北区,高田東二丁目,71,15,7,8
2016/9/30,141097,港北区,高田東二丁目,72,15,5,10
2016/9/30,141097,港北区,高田東二丁目,73,15,5,10
2016/9/30,141097,港北区,高田東二丁目,74,19,8,11
2016/9/30,141097,港北区,高田東二丁目,75,21,12,9
2016/9/30,141097,港北区,高田東二丁目,76,18,12,6
2016/9/30,141097,港北区,高田東二丁目,77,11,4,7
2016/9/30,141097,港北区,高田東二丁目,78,20,5,15
2016/9/30,141097,港北区,高田東二丁目,79,11,2,9
2016/9/30,141097,港北区,高田東二丁目,80,15,6,9
2016/9/30,141097,港北区,高田東二丁目,81,10,4,6
2016/9/30,141097,港北区,高田東二丁目,82,12,7,5
2016/9/30,141097,港北区,高田東二丁目,83,10,4,6
2016/9/30,141097,港北区,高田東二丁目,84,6,3,3
2016/9/30,141097,港北区,高田東二丁目,85,4,3,1
2016/9/30,141097,港北区,高田東二丁目,86,10,4,6
2016/9/30,141097,港北区,高田東二丁目,87,5,1,4
2016/9/30,141097,港北区,高田東二丁目,88,3,1,2
2016/9/30,141097,港北区,高田東二丁目,89,6,2,4
2016/9/30,141097,港北区,高田東二丁目,90,3,1,2
2016/9/30,141097,港北区,高田東二丁目,91,2,0,2
2016/9/30,141097,港北区,高田東二丁目,92,4,2,2
2016/9/30,141097,港北区,高田東二丁目,93,0,0,0
2016/9/30,141097,港北区,高田東二丁目,94,0,0,0
2016/9/30,141097,港北区,高田東二丁目,95,3,1,2
2016/9/30,141097,港北区,高田東二丁目,96,0,0,0
2016/9/30,141097,港北区,高田東二丁目,97,0,0,0
2016/9/30,141097,港北区,高田東二丁目,98,3,1,2
2016/9/30,141097,港北区,高田東二丁目,99,0,0,0
2016/9/30,141097,港北区,高田東二丁目,100,0,0,0
2016/9/30,141097,港北区,高田東三丁目,合計,2248,1143,1105
2016/9/30,141097,港北区,高田東三丁目,0,21,12,9
2016/9/30,141097,港北区,高田東三丁目,1,22,12,10
2016/9/30,141097,港北区,高田東三丁目,2,20,9,11
2016/9/30,141097,港北区,高田東三丁目,3,22,14,8
2016/9/30,141097,港北区,高田東三丁目,4,21,11,10
2016/9/30,141097,港北区,高田東三丁目,5,20,13,7
2016/9/30,141097,港北区,高田東三丁目,6,17,9,8
2016/9/30,141097,港北区,高田東三丁目,7,22,9,13
2016/9/30,141097,港北区,高田東三丁目,8,19,12,7
2016/9/30,141097,港北区,高田東三丁目,9,20,10,10
2016/9/30,141097,港北区,高田東三丁目,10,21,14,7
2016/9/30,141097,港北区,高田東三丁目,11,12,3,9
2016/9/30,141097,港北区,高田東三丁目,12,21,11,10
2016/9/30,141097,港北区,高田東三丁目,13,16,7,9
2016/9/30,141097,港北区,高田東三丁目,14,21,14,7
2016/9/30,141097,港北区,高田東三丁目,15,19,10,9
2016/9/30,141097,港北区,高田東三丁目,16,17,10,7
2016/9/30,141097,港北区,高田東三丁目,17,13,8,5
2016/9/30,141097,港北区,高田東三丁目,18,22,10,12
2016/9/30,141097,港北区,高田東三丁目,19,19,8,11
2016/9/30,141097,港北区,高田東三丁目,20,21,13,8
2016/9/30,141097,港北区,高田東三丁目,21,34,17,17
2016/9/30,141097,港北区,高田東三丁目,22,19,11,8
2016/9/30,141097,港北区,高田東三丁目,23,19,12,7
2016/9/30,141097,港北区,高田東三丁目,24,26,11,15
2016/9/30,141097,港北区,高田東三丁目,25,22,14,8
2016/9/30,141097,港北区,高田東三丁目,26,21,12,9
2016/9/30,141097,港北区,高田東三丁目,27,22,13,9
2016/9/30,141097,港北区,高田東三丁目,28,23,9,14
2016/9/30,141097,港北区,高田東三丁目,29,25,14,11
2016/9/30,141097,港北区,高田東三丁目,30,24,12,12
2016/9/30,141097,港北区,高田東三丁目,31,36,16,20
2016/9/30,141097,港北区,高田東三丁目,32,29,18,11
2016/9/30,141097,港北区,高田東三丁目,33,24,11,13
2016/9/30,141097,港北区,高田東三丁目,34,26,8,18
2016/9/30,141097,港北区,高田東三丁目,35,24,13,11
2016/9/30,141097,港北区,高田東三丁目,36,34,21,13
2016/9/30,141097,港北区,高田東三丁目,37,26,14,12
2016/9/30,141097,港北区,高田東三丁目,38,43,21,22
2016/9/30,141097,港北区,高田東三丁目,39,30,12,18
2016/9/30,141097,港北区,高田東三丁目,40,50,28,22
2016/9/30,141097,港北区,高田東三丁目,41,42,22,20
2016/9/30,141097,港北区,高田東三丁目,42,46,26,20
2016/9/30,141097,港北区,高田東三丁目,43,37,20,17
2016/9/30,141097,港北区,高田東三丁目,44,41,17,24
2016/9/30,141097,港北区,高田東三丁目,45,34,14,20
2016/9/30,141097,港北区,高田東三丁目,46,47,23,24
2016/9/30,141097,港北区,高田東三丁目,47,54,28,26
2016/9/30,141097,港北区,高田東三丁目,48,39,28,11
2016/9/30,141097,港北区,高田東三丁目,49,48,36,12
2016/9/30,141097,港北区,高田東三丁目,50,30,14,16
2016/9/30,141097,港北区,高田東三丁目,51,39,20,19
2016/9/30,141097,港北区,高田東三丁目,52,23,13,10
2016/9/30,141097,港北区,高田東三丁目,53,31,14,17
2016/9/30,141097,港北区,高田東三丁目,54,31,15,16
2016/9/30,141097,港北区,高田東三丁目,55,25,13,12
2016/9/30,141097,港北区,高田東三丁目,56,17,10,7
2016/9/30,141097,港北区,高田東三丁目,57,27,14,13
2016/9/30,141097,港北区,高田東三丁目,58,12,9,3
2016/9/30,141097,港北区,高田東三丁目,59,20,13,7
2016/9/30,141097,港北区,高田東三丁目,60,23,10,13
2016/9/30,141097,港北区,高田東三丁目,61,16,9,7
2016/9/30,141097,港北区,高田東三丁目,62,31,17,14
2016/9/30,141097,港北区,高田東三丁目,63,20,12,8
2016/9/30,141097,港北区,高田東三丁目,64,11,5,6
2016/9/30,141097,港北区,高田東三丁目,65,17,10,7
2016/9/30,141097,港北区,高田東三丁目,66,23,12,11
2016/9/30,141097,港北区,高田東三丁目,67,22,11,11
2016/9/30,141097,港北区,高田東三丁目,68,27,15,12
2016/9/30,141097,港北区,高田東三丁目,69,32,16,16
2016/9/30,141097,港北区,高田東三丁目,70,14,4,10
2016/9/30,141097,港北区,高田東三丁目,71,17,8,9
2016/9/30,141097,港北区,高田東三丁目,72,39,9,30
2016/9/30,141097,港北区,高田東三丁目,73,26,12,14
2016/9/30,141097,港北区,高田東三丁目,74,28,13,15
2016/9/30,141097,港北区,高田東三丁目,75,22,11,11
2016/9/30,141097,港北区,高田東三丁目,76,20,9,11
2016/9/30,141097,港北区,高田東三丁目,77,26,9,17
2016/9/30,141097,港北区,高田東三丁目,78,23,7,16
2016/9/30,141097,港北区,高田東三丁目,79,22,13,9
2016/9/30,141097,港北区,高田東三丁目,80,24,10,14
2016/9/30,141097,港北区,高田東三丁目,81,24,9,15
2016/9/30,141097,港北区,高田東三丁目,82,17,7,10
2016/9/30,141097,港北区,高田東三丁目,83,17,10,7
2016/9/30,141097,港北区,高田東三丁目,84,14,4,10
2016/9/30,141097,港北区,高田東三丁目,85,15,3,12
2016/9/30,141097,港北区,高田東三丁目,86,14,8,6
2016/9/30,141097,港北区,高田東三丁目,87,11,7,4
2016/9/30,141097,港北区,高田東三丁目,88,9,2,7
2016/9/30,141097,港北区,高田東三丁目,89,7,2,5
2016/9/30,141097,港北区,高田東三丁目,90,7,3,4
2016/9/30,141097,港北区,高田東三丁目,91,7,4,3
2016/9/30,141097,港北区,高田東三丁目,92,5,2,3
2016/9/30,141097,港北区,高田東三丁目,93,2,0,2
2016/9/30,141097,港北区,高田東三丁目,94,3,2,1
2016/9/30,141097,港北区,高田東三丁目,95,0,0,0
2016/9/30,141097,港北区,高田東三丁目,96,4,2,2
2016/9/30,141097,港北区,高田東三丁目,97,1,0,1
2016/9/30,141097,港北区,高田東三丁目,98,1,0,1
2016/9/30,141097,港北区,高田東三丁目,99,0,0,0
2016/9/30,141097,港北区,高田東三丁目,100,1,1,0
2016/9/30,141097,港北区,高田東四丁目,合計,2229,1131,1098
2016/9/30,141097,港北区,高田東四丁目,0,24,14,10
2016/9/30,141097,港北区,高田東四丁目,1,29,13,16
2016/9/30,141097,港北区,高田東四丁目,2,27,11,16
2016/9/30,141097,港北区,高田東四丁目,3,10,4,6
2016/9/30,141097,港北区,高田東四丁目,4,20,14,6
2016/9/30,141097,港北区,高田東四丁目,5,17,8,9
2016/9/30,141097,港北区,高田東四丁目,6,14,6,8
2016/9/30,141097,港北区,高田東四丁目,7,8,4,4
2016/9/30,141097,港北区,高田東四丁目,8,16,10,6
2016/9/30,141097,港北区,高田東四丁目,9,12,4,8
2016/9/30,141097,港北区,高田東四丁目,10,8,6,2
2016/9/30,141097,港北区,高田東四丁目,11,16,9,7
2016/9/30,141097,港北区,高田東四丁目,12,12,9,3
2016/9/30,141097,港北区,高田東四丁目,13,14,8,6
2016/9/30,141097,港北区,高田東四丁目,14,2,1,1
2016/9/30,141097,港北区,高田東四丁目,15,12,7,5
2016/9/30,141097,港北区,高田東四丁目,16,15,6,9
2016/9/30,141097,港北区,高田東四丁目,17,22,11,11
2016/9/30,141097,港北区,高田東四丁目,18,18,9,9
2016/9/30,141097,港北区,高田東四丁目,19,22,13,9
2016/9/30,141097,港北区,高田東四丁目,20,26,10,16
2016/9/30,141097,港北区,高田東四丁目,21,20,7,13
2016/9/30,141097,港北区,高田東四丁目,22,30,18,12
2016/9/30,141097,港北区,高田東四丁目,23,24,16,8
2016/9/30,141097,港北区,高田東四丁目,24,25,11,14
2016/9/30,141097,港北区,高田東四丁目,25,24,12,12
2016/9/30,141097,港北区,高田東四丁目,26,36,14,22
2016/9/30,141097,港北区,高田東四丁目,27,44,18,26
2016/9/30,141097,港北区,高田東四丁目,28,47,24,23
2016/9/30,141097,港北区,高田東四丁目,29,33,21,12
2016/9/30,141097,港北区,高田東四丁目,30,41,19,22
2016/9/30,141097,港北区,高田東四丁目,31,40,20,20
2016/9/30,141097,港北区,高田東四丁目,32,43,21,22
2016/9/30,141097,港北区,高田東四丁目,33,37,23,14
2016/9/30,141097,港北区,高田東四丁目,34,41,22,19
2016/9/30,141097,港北区,高田東四丁目,35,35,16,19
2016/9/30,141097,港北区,高田東四丁目,36,43,23,20
2016/9/30,141097,港北区,高田東四丁目,37,36,20,16
2016/9/30,141097,港北区,高田東四丁目,38,41,26,15
2016/9/30,141097,港北区,高田東四丁目,39,29,14,15
2016/9/30,141097,港北区,高田東四丁目,40,45,27,18
2016/9/30,141097,港北区,高田東四丁目,41,42,22,20
2016/9/30,141097,港北区,高田東四丁目,42,37,21,16
2016/9/30,141097,港北区,高田東四丁目,43,37,24,13
2016/9/30,141097,港北区,高田東四丁目,44,46,29,17
2016/9/30,141097,港北区,高田東四丁目,45,37,17,20
2016/9/30,141097,港北区,高田東四丁目,46,35,19,16
2016/9/30,141097,港北区,高田東四丁目,47,31,22,9
2016/9/30,141097,港北区,高田東四丁目,48,34,20,14
2016/9/30,141097,港北区,高田東四丁目,49,26,9,17
2016/9/30,141097,港北区,高田東四丁目,50,34,17,17
2016/9/30,141097,港北区,高田東四丁目,51,31,17,14
2016/9/30,141097,港北区,高田東四丁目,52,28,12,16
2016/9/30,141097,港北区,高田東四丁目,53,33,15,18
2016/9/30,141097,港北区,高田東四丁目,54,24,18,6
2016/9/30,141097,港北区,高田東四丁目,55,23,9,14
2016/9/30,141097,港北区,高田東四丁目,56,26,14,12
2016/9/30,141097,港北区,高田東四丁目,57,18,8,10
2016/9/30,141097,港北区,高田東四丁目,58,30,13,17
2016/9/30,141097,港北区,高田東四丁目,59,23,12,11
2016/9/30,141097,港北区,高田東四丁目,60,31,15,16
2016/9/30,141097,港北区,高田東四丁目,61,27,10,17
2016/9/30,141097,港北区,高田東四丁目,62,25,15,10
2016/9/30,141097,港北区,高田東四丁目,63,26,10,16
2016/9/30,141097,港北区,高田東四丁目,64,26,12,14
2016/9/30,141097,港北区,高田東四丁目,65,24,12,12
2016/9/30,141097,港北区,高田東四丁目,66,26,14,12
2016/9/30,141097,港北区,高田東四丁目,67,23,12,11
2016/9/30,141097,港北区,高田東四丁目,68,31,16,15
2016/9/30,141097,港北区,高田東四丁目,69,33,18,15
2016/9/30,141097,港北区,高田東四丁目,70,23,15,8
2016/9/30,141097,港北区,高田東四丁目,71,23,11,12
2016/9/30,141097,港北区,高田東四丁目,72,18,10,8
2016/9/30,141097,港北区,高田東四丁目,73,32,15,17
2016/9/30,141097,港北区,高田東四丁目,74,17,7,10
2016/9/30,141097,港北区,高田東四丁目,75,18,6,12
2016/9/30,141097,港北区,高田東四丁目,76,21,12,9
2016/9/30,141097,港北区,高田東四丁目,77,19,8,11
2016/9/30,141097,港北区,高田東四丁目,78,15,7,8
2016/9/30,141097,港北区,高田東四丁目,79,8,5,3
2016/9/30,141097,港北区,高田東四丁目,80,13,3,10
2016/9/30,141097,港北区,高田東四丁目,81,15,7,8
2016/9/30,141097,港北区,高田東四丁目,82,11,4,7
2016/9/30,141097,港北区,高田東四丁目,83,7,3,4
2016/9/30,141097,港北区,高田東四丁目,84,6,2,4
2016/9/30,141097,港北区,高田東四丁目,85,15,4,11
2016/9/30,141097,港北区,高田東四丁目,86,9,2,7
2016/9/30,141097,港北区,高田東四丁目,87,4,1,3
2016/9/30,141097,港北区,高田東四丁目,88,5,3,2
2016/9/30,141097,港北区,高田東四丁目,89,5,1,4
2016/9/30,141097,港北区,高田東四丁目,90,2,1,1
2016/9/30,141097,港北区,高田東四丁目,91,4,1,3
2016/9/30,141097,港北区,高田東四丁目,92,4,0,4
2016/9/30,141097,港北区,高田東四丁目,93,4,1,3
2016/9/30,141097,港北区,高田東四丁目,94,3,1,2
2016/9/30,141097,港北区,高田東四丁目,95,1,0,1
2016/9/30,141097,港北区,高田東四丁目,96,2,0,2
2016/9/30,141097,港北区,高田東四丁目,97,0,0,0
2016/9/30,141097,港北区,高田東四丁目,98,0,0,0
2016/9/30,141097,港北区,高田東四丁目,99,0,0,0
2016/9/30,141097,港北区,高田東四丁目,100,0,0,0
2016/9/30,141097,港北区,高田西一丁目,合計,2213,1124,1089
2016/9/30,141097,港北区,高田西一丁目,0,32,22,10
2016/9/30,141097,港北区,高田西一丁目,1,27,9,18
2016/9/30,141097,港北区,高田西一丁目,2,35,18,17
2016/9/30,141097,港北区,高田西一丁目,3,32,18,14
2016/9/30,141097,港北区,高田西一丁目,4,35,24,11
2016/9/30,141097,港北区,高田西一丁目,5,29,12,17
2016/9/30,141097,港北区,高田西一丁目,6,20,10,10
2016/9/30,141097,港北区,高田西一丁目,7,18,5,13
2016/9/30,141097,港北区,高田西一丁目,8,16,7,9
2016/9/30,141097,港北区,高田西一丁目,9,17,11,6
2016/9/30,141097,港北区,高田西一丁目,10,7,5,2
2016/9/30,141097,港北区,高田西一丁目,11,16,12,4
2016/9/30,141097,港北区,高田西一丁目,12,9,7,2
2016/9/30,141097,港北区,高田西一丁目,13,17,6,11
2016/9/30,141097,港北区,高田西一丁目,14,16,11,5
2016/9/30,141097,港北区,高田西一丁目,15,10,3,7
2016/9/30,141097,港北区,高田西一丁目,16,18,4,14
2016/9/30,141097,港北区,高田西一丁目,17,21,9,12
2016/9/30,141097,港北区,高田西一丁目,18,21,12,9
2016/9/30,141097,港北区,高田西一丁目,19,16,7,9
2016/9/30,141097,港北区,高田西一丁目,20,9,6,3
2016/9/30,141097,港北区,高田西一丁目,21,20,11,9
2016/9/30,141097,港北区,高田西一丁目,22,16,9,7
2016/9/30,141097,港北区,高田西一丁目,23,18,4,14
2016/9/30,141097,港北区,高田西一丁目,24,11,5,6
2016/9/30,141097,港北区,高田西一丁目,25,21,11,10
2016/9/30,141097,港北区,高田西一丁目,26,18,8,10
2016/9/30,141097,港北区,高田西一丁目,27,20,9,11
2016/9/30,141097,港北区,高田西一丁目,28,24,13,11
2016/9/30,141097,港北区,高田西一丁目,29,22,9,13
2016/9/30,141097,港北区,高田西一丁目,30,35,20,15
2016/9/30,141097,港北区,高田西一丁目,31,36,16,20
2016/9/30,141097,港北区,高田西一丁目,32,40,20,20
2016/9/30,141097,港北区,高田西一丁目,33,43,24,19
2016/9/30,141097,港北区,高田西一丁目,34,39,21,18
2016/9/30,141097,港北区,高田西一丁目,35,40,23,17
2016/9/30,141097,港北区,高田西一丁目,36,52,27,25
2016/9/30,141097,港北区,高田西一丁目,37,49,28,21
2016/9/30,141097,港北区,高田西一丁目,38,48,27,21
2016/9/30,141097,港北区,高田西一丁目,39,44,28,16
2016/9/30,141097,港北区,高田西一丁目,40,43,23,20
2016/9/30,141097,港北区,高田西一丁目,41,51,30,21
2016/9/30,141097,港北区,高田西一丁目,42,28,14,14
2016/9/30,141097,港北区,高田西一丁目,43,41,19,22
2016/9/30,141097,港北区,高田西一丁目,44,42,28,14
2016/9/30,141097,港北区,高田西一丁目,45,44,25,19
2016/9/30,141097,港北区,高田西一丁目,46,47,28,19
2016/9/30,141097,港北区,高田西一丁目,47,33,18,15
2016/9/30,141097,港北区,高田西一丁目,48,38,20,18
2016/9/30,141097,港北区,高田西一丁目,49,27,16,11
2016/9/30,141097,港北区,高田西一丁目,50,26,13,13
2016/9/30,141097,港北区,高田西一丁目,51,31,16,15
2016/9/30,141097,港北区,高田西一丁目,52,19,14,5
2016/9/30,141097,港北区,高田西一丁目,53,23,9,14
2016/9/30,141097,港北区,高田西一丁目,54,19,10,9
2016/9/30,141097,港北区,高田西一丁目,55,14,8,6
2016/9/30,141097,港北区,高田西一丁目,56,8,7,1
2016/9/30,141097,港北区,高田西一丁目,57,18,8,10
2016/9/30,141097,港北区,高田西一丁目,58,17,8,9
2016/9/30,141097,港北区,高田西一丁目,59,28,15,13
2016/9/30,141097,港北区,高田西一丁目,60,28,14,14
2016/9/30,141097,港北区,高田西一丁目,61,13,6,7
2016/9/30,141097,港北区,高田西一丁目,62,16,7,9
2016/9/30,141097,港北区,高田西一丁目,63,20,11,9
2016/9/30,141097,港北区,高田西一丁目,64,15,6,9
2016/9/30,141097,港北区,高田西一丁目,65,30,16,14
2016/9/30,141097,港北区,高田西一丁目,66,35,20,15
2016/9/30,141097,港北区,高田西一丁目,67,30,12,18
2016/9/30,141097,港北区,高田西一丁目,68,39,17,22
2016/9/30,141097,港北区,高田西一丁目,69,40,16,24
2016/9/30,141097,港北区,高田西一丁目,70,14,6,8
2016/9/30,141097,港北区,高田西一丁目,71,29,13,16
2016/9/30,141097,港北区,高田西一丁目,72,28,10,18
2016/9/30,141097,港北区,高田西一丁目,73,25,12,13
2016/9/30,141097,港北区,高田西一丁目,74,26,13,13
2016/9/30,141097,港北区,高田西一丁目,75,23,6,17
2016/9/30,141097,港北区,高田西一丁目,76,25,16,9
2016/9/30,141097,港北区,高田西一丁目,77,20,10,10
2016/9/30,141097,港北区,高田西一丁目,78,22,9,13
2016/9/30,141097,港北区,高田西一丁目,79,12,5,7
2016/9/30,141097,港北区,高田西一丁目,80,10,5,5
2016/9/30,141097,港北区,高田西一丁目,81,7,2,5
2016/9/30,141097,港北区,高田西一丁目,82,10,4,6
2016/9/30,141097,港北区,高田西一丁目,83,7,4,3
2016/9/30,141097,港北区,高田西一丁目,84,13,4,9
2016/9/30,141097,港北区,高田西一丁目,85,10,2,8
2016/9/30,141097,港北区,高田西一丁目,86,6,5,1
2016/9/30,141097,港北区,高田西一丁目,87,8,3,5
2016/9/30,141097,港北区,高田西一丁目,88,9,3,6
2016/9/30,141097,港北区,高田西一丁目,89,6,1,5
2016/9/30,141097,港北区,高田西一丁目,90,3,2,1
2016/9/30,141097,港北区,高田西一丁目,91,3,2,1
2016/9/30,141097,港北区,高田西一丁目,92,6,1,5
2016/9/30,141097,港北区,高田西一丁目,93,5,1,4
2016/9/30,141097,港北区,高田西一丁目,94,0,0,0
2016/9/30,141097,港北区,高田西一丁目,95,2,0,2
2016/9/30,141097,港北区,高田西一丁目,96,1,0,1
2016/9/30,141097,港北区,高田西一丁目,97,0,0,0
2016/9/30,141097,港北区,高田西一丁目,98,2,0,2
2016/9/30,141097,港北区,高田西一丁目,99,0,0,0
2016/9/30,141097,港北区,高田西一丁目,100,1,0,1
2016/9/30,141097,港北区,高田西二丁目,合計,1468,732,736
2016/9/30,141097,港北区,高田西二丁目,0,19,4,15
2016/9/30,141097,港北区,高田西二丁目,1,11,6,5
2016/9/30,141097,港北区,高田西二丁目,2,7,3,4
2016/9/30,141097,港北区,高田西二丁目,3,8,2,6
2016/9/30,141097,港北区,高田西二丁目,4,6,3,3
2016/9/30,141097,港北区,高田西二丁目,5,16,10,6
2016/9/30,141097,港北区,高田西二丁目,6,11,4,7
2016/9/30,141097,港北区,高田西二丁目,7,10,6,4
2016/9/30,141097,港北区,高田西二丁目,8,13,8,5
2016/9/30,141097,港北区,高田西二丁目,9,16,10,6
2016/9/30,141097,港北区,高田西二丁目,10,10,7,3
2016/9/30,141097,港北区,高田西二丁目,11,11,4,7
2016/9/30,141097,港北区,高田西二丁目,12,8,6,2
2016/9/30,141097,港北区,高田西二丁目,13,13,7,6
2016/9/30,141097,港北区,高田西二丁目,14,12,7,5
2016/9/30,141097,港北区,高田西二丁目,15,12,9,3
2016/9/30,141097,港北区,高田西二丁目,16,13,9,4
2016/9/30,141097,港北区,高田西二丁目,17,9,2,7
2016/9/30,141097,港北区,高田西二丁目,18,10,6,4
2016/9/30,141097,港北区,高田西二丁目,19,20,12,8
2016/9/30,141097,港北区,高田西二丁目,20,9,6,3
2016/9/30,141097,港北区,高田西二丁目,21,15,11,4
2016/9/30,141097,港北区,高田西二丁目,22,18,9,9
2016/9/30,141097,港北区,高田西二丁目,23,14,7,7
2016/9/30,141097,港北区,高田西二丁目,24,24,10,14
2016/9/30,141097,港北区,高田西二丁目,25,12,6,6
2016/9/30,141097,港北区,高田西二丁目,26,23,13,10
2016/9/30,141097,港北区,高田西二丁目,27,22,8,14
2016/9/30,141097,港北区,高田西二丁目,28,18,11,7
2016/9/30,141097,港北区,高田西二丁目,29,27,9,18
2016/9/30,141097,港北区,高田西二丁目,30,20,9,11
2016/9/30,141097,港北区,高田西二丁目,31,23,10,13
2016/9/30,141097,港北区,高田西二丁目,32,22,10,12
2016/9/30,141097,港北区,高田西二丁目,33,25,11,14
2016/9/30,141097,港北区,高田西二丁目,34,26,11,15
2016/9/30,141097,港北区,高田西二丁目,35,21,12,9
2016/9/30,141097,港北区,高田西二丁目,36,25,18,7
2016/9/30,141097,港北区,高田西二丁目,37,20,11,9
2016/9/30,141097,港北区,高田西二丁目,38,23,11,12
2016/9/30,141097,港北区,高田西二丁目,39,25,12,13
2016/9/30,141097,港北区,高田西二丁目,40,32,13,19
2016/9/30,141097,港北区,高田西二丁目,41,29,14,15
2016/9/30,141097,港北区,高田西二丁目,42,27,17,10
2016/9/30,141097,港北区,高田西二丁目,43,31,17,14
2016/9/30,141097,港北区,高田西二丁目,44,29,15,14
2016/9/30,141097,港北区,高田西二丁目,45,17,8,9
2016/9/30,141097,港北区,高田西二丁目,46,30,17,13
2016/9/30,141097,港北区,高田西二丁目,47,23,11,12
2016/9/30,141097,港北区,高田西二丁目,48,27,14,13
2016/9/30,141097,港北区,高田西二丁目,49,18,10,8
2016/9/30,141097,港北区,高田西二丁目,50,16,8,8
2016/9/30,141097,港北区,高田西二丁目,51,32,15,17
2016/9/30,141097,港北区,高田西二丁目,52,20,12,8
2016/9/30,141097,港北区,高田西二丁目,53,13,8,5
2016/9/30,141097,港北区,高田西二丁目,54,17,10,7
2016/9/30,141097,港北区,高田西二丁目,55,13,6,7
2016/9/30,141097,港北区,高田西二丁目,56,15,6,9
2016/9/30,141097,港北区,高田西二丁目,57,16,9,7
2016/9/30,141097,港北区,高田西二丁目,58,12,6,6
2016/9/30,141097,港北区,高田西二丁目,59,12,7,5
2016/9/30,141097,港北区,高田西二丁目,60,13,8,5
2016/9/30,141097,港北区,高田西二丁目,61,14,6,8
2016/9/30,141097,港北区,高田西二丁目,62,18,10,8
2016/9/30,141097,港北区,高田西二丁目,63,4,2,2
2016/9/30,141097,港北区,高田西二丁目,64,13,10,3
2016/9/30,141097,港北区,高田西二丁目,65,12,8,4
2016/9/30,141097,港北区,高田西二丁目,66,13,3,10
2016/9/30,141097,港北区,高田西二丁目,67,17,5,12
2016/9/30,141097,港北区,高田西二丁目,68,25,10,15
2016/9/30,141097,港北区,高田西二丁目,69,26,12,14
2016/9/30,141097,港北区,高田西二丁目,70,16,9,7
2016/9/30,141097,港北区,高田西二丁目,71,16,7,9
2016/9/30,141097,港北区,高田西二丁目,72,12,5,7
2016/9/30,141097,港北区,高田西二丁目,73,13,6,7
2016/9/30,141097,港北区,高田西二丁目,74,16,6,10
2016/9/30,141097,港北区,高田西二丁目,75,13,7,6
2016/9/30,141097,港北区,高田西二丁目,76,19,10,9
2016/9/30,141097,港北区,高田西二丁目,77,13,4,9
2016/9/30,141097,港北区,高田西二丁目,78,15,10,5
2016/9/30,141097,港北区,高田西二丁目,79,12,3,9
2016/9/30,141097,港北区,高田西二丁目,80,16,6,10
2016/9/30,141097,港北区,高田西二丁目,81,8,4,4
2016/9/30,141097,港北区,高田西二丁目,82,10,3,7
2016/9/30,141097,港北区,高田西二丁目,83,12,5,7
2016/9/30,141097,港北区,高田西二丁目,84,3,3,0
2016/9/30,141097,港北区,高田西二丁目,85,11,5,6
2016/9/30,141097,港北区,高田西二丁目,86,6,2,4
2016/9/30,141097,港北区,高田西二丁目,87,5,2,3
2016/9/30,141097,港北区,高田西二丁目,88,5,3,2
2016/9/30,141097,港北区,高田西二丁目,89,5,3,2
2016/9/30,141097,港北区,高田西二丁目,90,5,1,4
2016/9/30,141097,港北区,高田西二丁目,91,0,0,0
2016/9/30,141097,港北区,高田西二丁目,92,0,0,0
2016/9/30,141097,港北区,高田西二丁目,93,0,0,0
2016/9/30,141097,港北区,高田西二丁目,94,1,1,0
2016/9/30,141097,港北区,高田西二丁目,95,1,0,1
2016/9/30,141097,港北区,高田西二丁目,96,1,0,1
2016/9/30,141097,港北区,高田西二丁目,97,2,0,2
2016/9/30,141097,港北区,高田西二丁目,98,1,0,1
2016/9/30,141097,港北区,高田西二丁目,99,0,0,0
2016/9/30,141097,港北区,高田西二丁目,100,0,0,0
2016/9/30,141097,港北区,高田西三丁目,合計,1629,793,836
2016/9/30,141097,港北区,高田西三丁目,0,22,16,6
2016/9/30,141097,港北区,高田西三丁目,1,15,10,5
2016/9/30,141097,港北区,高田西三丁目,2,15,7,8
2016/9/30,141097,港北区,高田西三丁目,3,14,3,11
2016/9/30,141097,港北区,高田西三丁目,4,13,6,7
2016/9/30,141097,港北区,高田西三丁目,5,14,9,5
2016/9/30,141097,港北区,高田西三丁目,6,15,5,10
2016/9/30,141097,港北区,高田西三丁目,7,10,2,8
2016/9/30,141097,港北区,高田西三丁目,8,15,9,6
2016/9/30,141097,港北区,高田西三丁目,9,9,5,4
2016/9/30,141097,港北区,高田西三丁目,10,13,5,8
2016/9/30,141097,港北区,高田西三丁目,11,15,8,7
2016/9/30,141097,港北区,高田西三丁目,12,15,10,5
2016/9/30,141097,港北区,高田西三丁目,13,15,9,6
2016/9/30,141097,港北区,高田西三丁目,14,10,7,3
2016/9/30,141097,港北区,高田西三丁目,15,22,13,9
2016/9/30,141097,港北区,高田西三丁目,16,17,8,9
2016/9/30,141097,港北区,高田西三丁目,17,12,5,7
2016/9/30,141097,港北区,高田西三丁目,18,16,10,6
2016/9/30,141097,港北区,高田西三丁目,19,16,9,7
2016/9/30,141097,港北区,高田西三丁目,20,17,7,10
2016/9/30,141097,港北区,高田西三丁目,21,13,6,7
2016/9/30,141097,港北区,高田西三丁目,22,19,10,9
2016/9/30,141097,港北区,高田西三丁目,23,11,6,5
2016/9/30,141097,港北区,高田西三丁目,24,24,11,13
2016/9/30,141097,港北区,高田西三丁目,25,18,10,8
2016/9/30,141097,港北区,高田西三丁目,26,12,8,4
2016/9/30,141097,港北区,高田西三丁目,27,16,6,10
2016/9/30,141097,港北区,高田西三丁目,28,26,14,12
2016/9/30,141097,港北区,高田西三丁目,29,15,8,7
2016/9/30,141097,港北区,高田西三丁目,30,26,12,14
2016/9/30,141097,港北区,高田西三丁目,31,15,8,7
2016/9/30,141097,港北区,高田西三丁目,32,15,5,10
2016/9/30,141097,港北区,高田西三丁目,33,27,12,15
2016/9/30,141097,港北区,高田西三丁目,34,27,15,12
2016/9/30,141097,港北区,高田西三丁目,35,22,14,8
2016/9/30,141097,港北区,高田西三丁目,36,21,11,10
2016/9/30,141097,港北区,高田西三丁目,37,20,12,8
2016/9/30,141097,港北区,高田西三丁目,38,30,13,17
2016/9/30,141097,港北区,高田西三丁目,39,25,15,10
2016/9/30,141097,港北区,高田西三丁目,40,20,10,10
2016/9/30,141097,港北区,高田西三丁目,41,26,13,13
2016/9/30,141097,港北区,高田西三丁目,42,29,12,17
2016/9/30,141097,港北区,高田西三丁目,43,19,14,5
2016/9/30,141097,港北区,高田西三丁目,44,23,11,12
2016/9/30,141097,港北区,高田西三丁目,45,33,20,13
2016/9/30,141097,港北区,高田西三丁目,46,24,12,12
2016/9/30,141097,港北区,高田西三丁目,47,27,10,17
2016/9/30,141097,港北区,高田西三丁目,48,16,8,8
2016/9/30,141097,港北区,高田西三丁目,49,28,15,13
2016/9/30,141097,港北区,高田西三丁目,50,17,6,11
2016/9/30,141097,港北区,高田西三丁目,51,28,11,17
2016/9/30,141097,港北区,高田西三丁目,52,23,13,10
2016/9/30,141097,港北区,高田西三丁目,53,25,12,13
2016/9/30,141097,港北区,高田西三丁目,54,16,11,5
2016/9/30,141097,港北区,高田西三丁目,55,13,4,9
2016/9/30,141097,港北区,高田西三丁目,56,15,5,10
2016/9/30,141097,港北区,高田西三丁目,57,19,7,12
2016/9/30,141097,港北区,高田西三丁目,58,20,11,9
2016/9/30,141097,港北区,高田西三丁目,59,20,9,11
2016/9/30,141097,港北区,高田西三丁目,60,14,8,6
2016/9/30,141097,港北区,高田西三丁目,61,17,9,8
2016/9/30,141097,港北区,高田西三丁目,62,20,9,11
2016/9/30,141097,港北区,高田西三丁目,63,17,7,10
2016/9/30,141097,港北区,高田西三丁目,64,21,7,14
2016/9/30,141097,港北区,高田西三丁目,65,30,16,14
2016/9/30,141097,港北区,高田西三丁目,66,24,11,13
2016/9/30,141097,港北区,高田西三丁目,67,17,12,5
2016/9/30,141097,港北区,高田西三丁目,68,25,10,15
2016/9/30,141097,港北区,高田西三丁目,69,26,10,16
2016/9/30,141097,港北区,高田西三丁目,70,16,9,7
2016/9/30,141097,港北区,高田西三丁目,71,13,7,6
2016/9/30,141097,港北区,高田西三丁目,72,16,11,5
2016/9/30,141097,港北区,高田西三丁目,73,18,6,12
2016/9/30,141097,港北区,高田西三丁目,74,18,13,5
2016/9/30,141097,港北区,高田西三丁目,75,14,6,8
2016/9/30,141097,港北区,高田西三丁目,76,19,7,12
2016/9/30,141097,港北区,高田西三丁目,77,12,5,7
2016/9/30,141097,港北区,高田西三丁目,78,13,5,8
2016/9/30,141097,港北区,高田西三丁目,79,13,3,10
2016/9/30,141097,港北区,高田西三丁目,80,16,8,8
2016/9/30,141097,港北区,高田西三丁目,81,12,7,5
2016/9/30,141097,港北区,高田西三丁目,82,16,5,11
2016/9/30,141097,港北区,高田西三丁目,83,9,3,6
2016/9/30,141097,港北区,高田西三丁目,84,10,4,6
2016/9/30,141097,港北区,高田西三丁目,85,11,5,6
2016/9/30,141097,港北区,高田西三丁目,86,7,2,5
2016/9/30,141097,港北区,高田西三丁目,87,12,4,8
2016/9/30,141097,港北区,高田西三丁目,88,10,2,8
2016/9/30,141097,港北区,高田西三丁目,89,6,1,5
2016/9/30,141097,港北区,高田西三丁目,90,5,2,3
2016/9/30,141097,港北区,高田西三丁目,91,3,0,3
2016/9/30,141097,港北区,高田西三丁目,92,2,0,2
2016/9/30,141097,港北区,高田西三丁目,93,4,1,3
2016/9/30,141097,港北区,高田西三丁目,94,4,3,1
2016/9/30,141097,港北区,高田西三丁目,95,2,0,2
2016/9/30,141097,港北区,高田西三丁目,96,1,0,1
2016/9/30,141097,港北区,高田西三丁目,97,1,1,0
2016/9/30,141097,港北区,高田西三丁目,98,1,0,1
2016/9/30,141097,港北区,高田西三丁目,99,1,1,0
2016/9/30,141097,港北区,高田西三丁目,100,0,0,0
2016/9/30,141097,港北区,高田西四丁目,合計,2211,1125,1086
2016/9/30,141097,港北区,高田西四丁目,0,23,10,13
2016/9/30,141097,港北区,高田西四丁目,1,13,7,6
2016/9/30,141097,港北区,高田西四丁目,2,14,6,8
2016/9/30,141097,港北区,高田西四丁目,3,14,8,6
2016/9/30,141097,港北区,高田西四丁目,4,19,7,12
2016/9/30,141097,港北区,高田西四丁目,5,13,4,9
2016/9/30,141097,港北区,高田西四丁目,6,21,8,13
2016/9/30,141097,港北区,高田西四丁目,7,20,6,14
2016/9/30,141097,港北区,高田西四丁目,8,19,11,8
2016/9/30,141097,港北区,高田西四丁目,9,19,11,8
2016/9/30,141097,港北区,高田西四丁目,10,19,11,8
2016/9/30,141097,港北区,高田西四丁目,11,12,4,8
2016/9/30,141097,港北区,高田西四丁目,12,10,5,5
2016/9/30,141097,港北区,高田西四丁目,13,27,16,11
2016/9/30,141097,港北区,高田西四丁目,14,22,8,14
2016/9/30,141097,港北区,高田西四丁目,15,19,7,12
2016/9/30,141097,港北区,高田西四丁目,16,27,21,6
2016/9/30,141097,港北区,高田西四丁目,17,13,5,8
2016/9/30,141097,港北区,高田西四丁目,18,18,8,10
2016/9/30,141097,港北区,高田西四丁目,19,24,11,13
2016/9/30,141097,港北区,高田西四丁目,20,28,15,13
2016/9/30,141097,港北区,高田西四丁目,21,24,10,14
2016/9/30,141097,港北区,高田西四丁目,22,23,13,10
2016/9/30,141097,港北区,高田西四丁目,23,25,10,15
2016/9/30,141097,港北区,高田西四丁目,24,30,15,15
2016/9/30,141097,港北区,高田西四丁目,25,18,11,7
2016/9/30,141097,港北区,高田西四丁目,26,18,9,9
2016/9/30,141097,港北区,高田西四丁目,27,21,15,6
2016/9/30,141097,港北区,高田西四丁目,28,14,6,8
2016/9/30,141097,港北区,高田西四丁目,29,17,10,7
2016/9/30,141097,港北区,高田西四丁目,30,18,9,9
2016/9/30,141097,港北区,高田西四丁目,31,20,9,11
2016/9/30,141097,港北区,高田西四丁目,32,17,10,7
2016/9/30,141097,港北区,高田西四丁目,33,16,6,10
2016/9/30,141097,港北区,高田西四丁目,34,23,13,10
2016/9/30,141097,港北区,高田西四丁目,35,31,18,13
2016/9/30,141097,港北区,高田西四丁目,36,31,15,16
2016/9/30,141097,港北区,高田西四丁目,37,30,16,14
2016/9/30,141097,港北区,高田西四丁目,38,30,15,15
2016/9/30,141097,港北区,高田西四丁目,39,25,16,9
2016/9/30,141097,港北区,高田西四丁目,40,36,22,14
2016/9/30,141097,港北区,高田西四丁目,41,41,21,20
2016/9/30,141097,港北区,高田西四丁目,42,44,21,23
2016/9/30,141097,港北区,高田西四丁目,43,43,24,19
2016/9/30,141097,港北区,高田西四丁目,44,36,15,21
2016/9/30,141097,港北区,高田西四丁目,45,47,27,20
2016/9/30,141097,港北区,高田西四丁目,46,39,20,19
2016/9/30,141097,港北区,高田西四丁目,47,35,25,10
2016/9/30,141097,港北区,高田西四丁目,48,54,29,25
2016/9/30,141097,港北区,高田西四丁目,49,27,14,13
2016/9/30,141097,港北区,高田西四丁目,50,27,16,11
2016/9/30,141097,港北区,高田西四丁目,51,31,19,12
2016/9/30,141097,港北区,高田西四丁目,52,38,22,16
2016/9/30,141097,港北区,高田西四丁目,53,35,17,18
2016/9/30,141097,港北区,高田西四丁目,54,29,16,13
2016/9/30,141097,港北区,高田西四丁目,55,32,17,15
2016/9/30,141097,港北区,高田西四丁目,56,21,13,8
2016/9/30,141097,港北区,高田西四丁目,57,30,16,14
2016/9/30,141097,港北区,高田西四丁目,58,30,10,20
2016/9/30,141097,港北区,高田西四丁目,59,23,14,9
2016/9/30,141097,港北区,高田西四丁目,60,22,11,11
2016/9/30,141097,港北区,高田西四丁目,61,28,17,11
2016/9/30,141097,港北区,高田西四丁目,62,20,10,10
2016/9/30,141097,港北区,高田西四丁目,63,22,13,9
2016/9/30,141097,港北区,高田西四丁目,64,33,19,14
2016/9/30,141097,港北区,高田西四丁目,65,32,9,23
2016/9/30,141097,港北区,高田西四丁目,66,26,15,11
2016/9/30,141097,港北区,高田西四丁目,67,24,9,15
2016/9/30,141097,港北区,高田西四丁目,68,41,15,26
2016/9/30,141097,港北区,高田西四丁目,69,38,18,20
2016/9/30,141097,港北区,高田西四丁目,70,25,15,10
2016/9/30,141097,港北区,高田西四丁目,71,16,9,7
2016/9/30,141097,港北区,高田西四丁目,72,31,12,19
2016/9/30,141097,港北区,高田西四丁目,73,35,19,16
2016/9/30,141097,港北区,高田西四丁目,74,24,16,8
2016/9/30,141097,港北区,高田西四丁目,75,35,13,22
2016/9/30,141097,港北区,高田西四丁目,76,27,13,14
2016/9/30,141097,港北区,高田西四丁目,77,23,5,18
2016/9/30,141097,港北区,高田西四丁目,78,25,12,13
2016/9/30,141097,港北区,高田西四丁目,79,26,16,10
2016/9/30,141097,港北区,高田西四丁目,80,18,12,6
2016/9/30,141097,港北区,高田西四丁目,81,20,11,9
2016/9/30,141097,港北区,高田西四丁目,82,11,4,7
2016/9/30,141097,港北区,高田西四丁目,83,15,8,7
2016/9/30,141097,港北区,高田西四丁目,84,17,13,4
2016/9/30,141097,港北区,高田西四丁目,85,10,2,8
2016/9/30,141097,港北区,高田西四丁目,86,7,5,2
2016/9/30,141097,港北区,高田西四丁目,87,10,3,7
2016/9/30,141097,港北区,高田西四丁目,88,5,1,4
2016/9/30,141097,港北区,高田西四丁目,89,3,0,3
2016/9/30,141097,港北区,高田西四丁目,90,7,2,5
2016/9/30,141097,港北区,高田西四丁目,91,4,1,3
2016/9/30,141097,港北区,高田西四丁目,92,6,4,2
2016/9/30,141097,港北区,高田西四丁目,93,0,0,0
2016/9/30,141097,港北区,高田西四丁目,94,0,0,0
2016/9/30,141097,港北区,高田西四丁目,95,1,0,1
2016/9/30,141097,港北区,高田西四丁目,96,0,0,0
2016/9/30,141097,港北区,高田西四丁目,97,0,0,0
2016/9/30,141097,港北区,高田西四丁目,98,0,0,0
2016/9/30,141097,港北区,高田西四丁目,99,0,0,0
2016/9/30,141097,港北区,高田西四丁目,100,1,0,1
2016/9/30,141097,港北区,高田西五丁目,合計,1821,863,958
2016/9/30,141097,港北区,高田西五丁目,0,14,11,3
2016/9/30,141097,港北区,高田西五丁目,1,14,7,7
2016/9/30,141097,港北区,高田西五丁目,2,9,6,3
2016/9/30,141097,港北区,高田西五丁目,3,4,1,3
2016/9/30,141097,港北区,高田西五丁目,4,17,5,12
2016/9/30,141097,港北区,高田西五丁目,5,16,5,11
2016/9/30,141097,港北区,高田西五丁目,6,10,5,5
2016/9/30,141097,港北区,高田西五丁目,7,17,9,8
2016/9/30,141097,港北区,高田西五丁目,8,11,5,6
2016/9/30,141097,港北区,高田西五丁目,9,11,8,3
2016/9/30,141097,港北区,高田西五丁目,10,22,10,12
2016/9/30,141097,港北区,高田西五丁目,11,12,1,11
2016/9/30,141097,港北区,高田西五丁目,12,13,2,11
2016/9/30,141097,港北区,高田西五丁目,13,17,8,9
2016/9/30,141097,港北区,高田西五丁目,14,21,9,12
2016/9/30,141097,港北区,高田西五丁目,15,18,12,6
2016/9/30,141097,港北区,高田西五丁目,16,19,11,8
2016/9/30,141097,港北区,高田西五丁目,17,25,12,13
2016/9/30,141097,港北区,高田西五丁目,18,15,5,10
2016/9/30,141097,港北区,高田西五丁目,19,21,11,10
2016/9/30,141097,港北区,高田西五丁目,20,12,6,6
2016/9/30,141097,港北区,高田西五丁目,21,21,11,10
2016/9/30,141097,港北区,高田西五丁目,22,20,12,8
2016/9/30,141097,港北区,高田西五丁目,23,17,9,8
2016/9/30,141097,港北区,高田西五丁目,24,16,4,12
2016/9/30,141097,港北区,高田西五丁目,25,17,7,10
2016/9/30,141097,港北区,高田西五丁目,26,16,8,8
2016/9/30,141097,港北区,高田西五丁目,27,12,6,6
2016/9/30,141097,港北区,高田西五丁目,28,13,8,5
2016/9/30,141097,港北区,高田西五丁目,29,17,8,9
2016/9/30,141097,港北区,高田西五丁目,30,11,3,8
2016/9/30,141097,港北区,高田西五丁目,31,21,9,12
2016/9/30,141097,港北区,高田西五丁目,32,14,8,6
2016/9/30,141097,港北区,高田西五丁目,33,13,10,3
2016/9/30,141097,港北区,高田西五丁目,34,12,7,5
2016/9/30,141097,港北区,高田西五丁目,35,18,9,9
2016/9/30,141097,港北区,高田西五丁目,36,16,8,8
2016/9/30,141097,港北区,高田西五丁目,37,10,3,7
2016/9/30,141097,港北区,高田西五丁目,38,16,8,8
2016/9/30,141097,港北区,高田西五丁目,39,29,16,13
2016/9/30,141097,港北区,高田西五丁目,40,29,12,17
2016/9/30,141097,港北区,高田西五丁目,41,29,15,14
2016/9/30,141097,港北区,高田西五丁目,42,36,22,14
2016/9/30,141097,港北区,高田西五丁目,43,26,11,15
2016/9/30,141097,港北区,高田西五丁目,44,34,14,20
2016/9/30,141097,港北区,高田西五丁目,45,49,24,25
2016/9/30,141097,港北区,高田西五丁目,46,40,19,21
2016/9/30,141097,港北区,高田西五丁目,47,20,10,10
2016/9/30,141097,港北区,高田西五丁目,48,26,9,17
2016/9/30,141097,港北区,高田西五丁目,49,32,20,12
2016/9/30,141097,港北区,高田西五丁目,50,24,15,9
2016/9/30,141097,港北区,高田西五丁目,51,29,11,18
2016/9/30,141097,港北区,高田西五丁目,52,31,15,16
2016/9/30,141097,港北区,高田西五丁目,53,26,17,9
2016/9/30,141097,港北区,高田西五丁目,54,26,15,11
2016/9/30,141097,港北区,高田西五丁目,55,21,8,13
2016/9/30,141097,港北区,高田西五丁目,56,27,12,15
2016/9/30,141097,港北区,高田西五丁目,57,32,15,17
2016/9/30,141097,港北区,高田西五丁目,58,14,8,6
2016/9/30,141097,港北区,高田西五丁目,59,12,8,4
2016/9/30,141097,港北区,高田西五丁目,60,26,11,15
2016/9/30,141097,港北区,高田西五丁目,61,19,12,7
2016/9/30,141097,港北区,高田西五丁目,62,16,5,11
2016/9/30,141097,港北区,高田西五丁目,63,15,8,7
2016/9/30,141097,港北区,高田西五丁目,64,20,12,8
2016/9/30,141097,港北区,高田西五丁目,65,13,8,5
2016/9/30,141097,港北区,高田西五丁目,66,20,6,14
2016/9/30,141097,港北区,高田西五丁目,67,32,15,17
2016/9/30,141097,港北区,高田西五丁目,68,32,19,13
2016/9/30,141097,港北区,高田西五丁目,69,41,13,28
2016/9/30,141097,港北区,高田西五丁目,70,17,7,10
2016/9/30,141097,港北区,高田西五丁目,71,24,13,11
2016/9/30,141097,港北区,高田西五丁目,72,33,16,17
2016/9/30,141097,港北区,高田西五丁目,73,20,10,10
2016/9/30,141097,港北区,高田西五丁目,74,29,9,20
2016/9/30,141097,港北区,高田西五丁目,75,23,11,12
2016/9/30,141097,港北区,高田西五丁目,76,31,13,18
2016/9/30,141097,港北区,高田西五丁目,77,19,8,11
2016/9/30,141097,港北区,高田西五丁目,78,23,8,15
2016/9/30,141097,港北区,高田西五丁目,79,19,9,10
2016/9/30,141097,港北区,高田西五丁目,80,23,11,12
2016/9/30,141097,港北区,高田西五丁目,81,18,6,12
2016/9/30,141097,港北区,高田西五丁目,82,17,8,9
2016/9/30,141097,港北区,高田西五丁目,83,9,5,4
2016/9/30,141097,港北区,高田西五丁目,84,24,8,16
2016/9/30,141097,港北区,高田西五丁目,85,16,11,5
2016/9/30,141097,港北区,高田西五丁目,86,14,7,7
2016/9/30,141097,港北区,高田西五丁目,87,7,3,4
2016/9/30,141097,港北区,高田西五丁目,88,7,1,6
2016/9/30,141097,港北区,高田西五丁目,89,2,1,1
2016/9/30,141097,港北区,高田西五丁目,90,2,0,2
2016/9/30,141097,港北区,高田西五丁目,91,6,2,4
2016/9/30,141097,港北区,高田西五丁目,92,5,3,2
2016/9/30,141097,港北区,高田西五丁目,93,2,0,2
2016/9/30,141097,港北区,高田西五丁目,94,2,0,2
2016/9/30,141097,港北区,高田西五丁目,95,1,0,1
2016/9/30,141097,港北区,高田西五丁目,96,1,0,1
2016/9/30,141097,港北区,高田西五丁目,97,0,0,0
2016/9/30,141097,港北区,高田西五丁目,98,0,0,0
2016/9/30,141097,港北区,高田西五丁目,99,2,1,1
2016/9/30,141097,港北区,高田西五丁目,100,1,0,1
2016/9/30,141097,港北区,新吉田東一丁目,合計,3464,1774,1690
2016/9/30,141097,港北区,新吉田東一丁目,0,33,19,14
2016/9/30,141097,港北区,新吉田東一丁目,1,25,12,13
2016/9/30,141097,港北区,新吉田東一丁目,2,30,15,15
2016/9/30,141097,港北区,新吉田東一丁目,3,30,19,11
2016/9/30,141097,港北区,新吉田東一丁目,4,23,14,9
2016/9/30,141097,港北区,新吉田東一丁目,5,28,14,14
2016/9/30,141097,港北区,新吉田東一丁目,6,25,14,11
2016/9/30,141097,港北区,新吉田東一丁目,7,24,13,11
2016/9/30,141097,港北区,新吉田東一丁目,8,23,13,10
2016/9/30,141097,港北区,新吉田東一丁目,9,26,16,10
2016/9/30,141097,港北区,新吉田東一丁目,10,19,12,7
2016/9/30,141097,港北区,新吉田東一丁目,11,20,9,11
2016/9/30,141097,港北区,新吉田東一丁目,12,27,14,13
2016/9/30,141097,港北区,新吉田東一丁目,13,32,14,18
2016/9/30,141097,港北区,新吉田東一丁目,14,27,10,17
2016/9/30,141097,港北区,新吉田東一丁目,15,38,20,18
2016/9/30,141097,港北区,新吉田東一丁目,16,34,17,17
2016/9/30,141097,港北区,新吉田東一丁目,17,33,16,17
2016/9/30,141097,港北区,新吉田東一丁目,18,31,21,10
2016/9/30,141097,港北区,新吉田東一丁目,19,27,12,15
2016/9/30,141097,港北区,新吉田東一丁目,20,31,14,17
2016/9/30,141097,港北区,新吉田東一丁目,21,34,19,15
2016/9/30,141097,港北区,新吉田東一丁目,22,34,22,12
2016/9/30,141097,港北区,新吉田東一丁目,23,36,16,20
2016/9/30,141097,港北区,新吉田東一丁目,24,36,16,20
2016/9/30,141097,港北区,新吉田東一丁目,25,36,16,20
2016/9/30,141097,港北区,新吉田東一丁目,26,42,21,21
2016/9/30,141097,港北区,新吉田東一丁目,27,39,20,19
2016/9/30,141097,港北区,新吉田東一丁目,28,31,18,13
2016/9/30,141097,港北区,新吉田東一丁目,29,52,20,32
2016/9/30,141097,港北区,新吉田東一丁目,30,57,33,24
2016/9/30,141097,港北区,新吉田東一丁目,31,44,32,12
2016/9/30,141097,港北区,新吉田東一丁目,32,53,29,24
2016/9/30,141097,港北区,新吉田東一丁目,33,57,30,27
2016/9/30,141097,港北区,新吉田東一丁目,34,45,32,13
2016/9/30,141097,港北区,新吉田東一丁目,35,51,22,29
2016/9/30,141097,港北区,新吉田東一丁目,36,46,31,15
2016/9/30,141097,港北区,新吉田東一丁目,37,55,29,26
2016/9/30,141097,港北区,新吉田東一丁目,38,53,29,24
2016/9/30,141097,港北区,新吉田東一丁目,39,62,35,27
2016/9/30,141097,港北区,新吉田東一丁目,40,58,34,24
2016/9/30,141097,港北区,新吉田東一丁目,41,48,27,21
2016/9/30,141097,港北区,新吉田東一丁目,42,66,32,34
2016/9/30,141097,港北区,新吉田東一丁目,43,57,32,25
2016/9/30,141097,港北区,新吉田東一丁目,44,50,27,23
2016/9/30,141097,港北区,新吉田東一丁目,45,82,38,44
2016/9/30,141097,港北区,新吉田東一丁目,46,64,34,30
2016/9/30,141097,港北区,新吉田東一丁目,47,59,30,29
2016/9/30,141097,港北区,新吉田東一丁目,48,62,37,25
2016/9/30,141097,港北区,新吉田東一丁目,49,59,33,26
2016/9/30,141097,港北区,新吉田東一丁目,50,42,26,16
2016/9/30,141097,港北区,新吉田東一丁目,51,43,25,18
2016/9/30,141097,港北区,新吉田東一丁目,52,44,20,24
2016/9/30,141097,港北区,新吉田東一丁目,53,40,18,22
2016/9/30,141097,港北区,新吉田東一丁目,54,38,23,15
2016/9/30,141097,港北区,新吉田東一丁目,55,41,18,23
2016/9/30,141097,港北区,新吉田東一丁目,56,41,23,18
2016/9/30,141097,港北区,新吉田東一丁目,57,30,15,15
2016/9/30,141097,港北区,新吉田東一丁目,58,33,15,18
2016/9/30,141097,港北区,新吉田東一丁目,59,28,20,8
2016/9/30,141097,港北区,新吉田東一丁目,60,30,17,13
2016/9/30,141097,港北区,新吉田東一丁目,61,40,21,19
2016/9/30,141097,港北区,新吉田東一丁目,62,38,17,21
2016/9/30,141097,港北区,新吉田東一丁目,63,43,25,18
2016/9/30,141097,港北区,新吉田東一丁目,64,51,26,25
2016/9/30,141097,港北区,新吉田東一丁目,65,42,16,26
2016/9/30,141097,港北区,新吉田東一丁目,66,46,23,23
2016/9/30,141097,港北区,新吉田東一丁目,67,49,27,22
2016/9/30,141097,港北区,新吉田東一丁目,68,61,33,28
2016/9/30,141097,港北区,新吉田東一丁目,69,49,16,33
2016/9/30,141097,港北区,新吉田東一丁目,70,41,19,22
2016/9/30,141097,港北区,新吉田東一丁目,71,47,16,31
2016/9/30,141097,港北区,新吉田東一丁目,72,50,21,29
2016/9/30,141097,港北区,新吉田東一丁目,73,47,20,27
2016/9/30,141097,港北区,新吉田東一丁目,74,36,21,15
2016/9/30,141097,港北区,新吉田東一丁目,75,43,20,23
2016/9/30,141097,港北区,新吉田東一丁目,76,32,21,11
2016/9/30,141097,港北区,新吉田東一丁目,77,28,12,16
2016/9/30,141097,港北区,新吉田東一丁目,78,25,13,12
2016/9/30,141097,港北区,新吉田東一丁目,79,27,12,15
2016/9/30,141097,港北区,新吉田東一丁目,80,32,13,19
2016/9/30,141097,港北区,新吉田東一丁目,81,31,13,18
2016/9/30,141097,港北区,新吉田東一丁目,82,22,9,13
2016/9/30,141097,港北区,新吉田東一丁目,83,21,8,13
2016/9/30,141097,港北区,新吉田東一丁目,84,15,1,14
2016/9/30,141097,港北区,新吉田東一丁目,85,13,5,8
2016/9/30,141097,港北区,新吉田東一丁目,86,10,5,5
2016/9/30,141097,港北区,新吉田東一丁目,87,12,4,8
2016/9/30,141097,港北区,新吉田東一丁目,88,12,4,8
2016/9/30,141097,港北区,新吉田東一丁目,89,7,5,2
2016/9/30,141097,港北区,新吉田東一丁目,90,3,2,1
2016/9/30,141097,港北区,新吉田東一丁目,91,5,0,5
2016/9/30,141097,港北区,新吉田東一丁目,92,1,1,0
2016/9/30,141097,港北区,新吉田東一丁目,93,6,1,5
2016/9/30,141097,港北区,新吉田東一丁目,94,4,1,3
2016/9/30,141097,港北区,新吉田東一丁目,95,2,0,2
2016/9/30,141097,港北区,新吉田東一丁目,96,1,0,1
2016/9/30,141097,港北区,新吉田東一丁目,97,3,0,3
2016/9/30,141097,港北区,新吉田東一丁目,98,1,0,1
2016/9/30,141097,港北区,新吉田東一丁目,99,2,0,2
2016/9/30,141097,港北区,新吉田東一丁目,100,2,1,1
2016/9/30,141097,港北区,新吉田東二丁目,合計,2420,1199,1221
2016/9/30,141097,港北区,新吉田東二丁目,0,14,9,5
2016/9/30,141097,港北区,新吉田東二丁目,1,27,15,12
2016/9/30,141097,港北区,新吉田東二丁目,2,29,15,14
2016/9/30,141097,港北区,新吉田東二丁目,3,18,7,11
2016/9/30,141097,港北区,新吉田東二丁目,4,25,14,11
2016/9/30,141097,港北区,新吉田東二丁目,5,16,9,7
2016/9/30,141097,港北区,新吉田東二丁目,6,15,10,5
2016/9/30,141097,港北区,新吉田東二丁目,7,15,10,5
2016/9/30,141097,港北区,新吉田東二丁目,8,26,12,14
2016/9/30,141097,港北区,新吉田東二丁目,9,15,8,7
2016/9/30,141097,港北区,新吉田東二丁目,10,20,11,9
2016/9/30,141097,港北区,新吉田東二丁目,11,16,9,7
2016/9/30,141097,港北区,新吉田東二丁目,12,17,7,10
2016/9/30,141097,港北区,新吉田東二丁目,13,15,9,6
2016/9/30,141097,港北区,新吉田東二丁目,14,14,5,9
2016/9/30,141097,港北区,新吉田東二丁目,15,26,13,13
2016/9/30,141097,港北区,新吉田東二丁目,16,14,7,7
2016/9/30,141097,港北区,新吉田東二丁目,17,21,10,11
2016/9/30,141097,港北区,新吉田東二丁目,18,25,14,11
2016/9/30,141097,港北区,新吉田東二丁目,19,11,6,5
2016/9/30,141097,港北区,新吉田東二丁目,20,23,10,13
2016/9/30,141097,港北区,新吉田東二丁目,21,21,12,9
2016/9/30,141097,港北区,新吉田東二丁目,22,26,16,10
2016/9/30,141097,港北区,新吉田東二丁目,23,20,13,7
2016/9/30,141097,港北区,新吉田東二丁目,24,18,10,8
2016/9/30,141097,港北区,新吉田東二丁目,25,21,9,12
2016/9/30,141097,港北区,新吉田東二丁目,26,18,10,8
2016/9/30,141097,港北区,新吉田東二丁目,27,20,9,11
2016/9/30,141097,港北区,新吉田東二丁目,28,25,11,14
2016/9/30,141097,港北区,新吉田東二丁目,29,21,11,10
2016/9/30,141097,港北区,新吉田東二丁目,30,33,13,20
2016/9/30,141097,港北区,新吉田東二丁目,31,44,24,20
2016/9/30,141097,港北区,新吉田東二丁目,32,36,16,20
2016/9/30,141097,港北区,新吉田東二丁目,33,41,19,22
2016/9/30,141097,港北区,新吉田東二丁目,34,32,13,19
2016/9/30,141097,港北区,新吉田東二丁目,35,28,13,15
2016/9/30,141097,港北区,新吉田東二丁目,36,36,21,15
2016/9/30,141097,港北区,新吉田東二丁目,37,30,18,12
2016/9/30,141097,港北区,新吉田東二丁目,38,42,16,26
2016/9/30,141097,港北区,新吉田東二丁目,39,37,20,17
2016/9/30,141097,港北区,新吉田東二丁目,40,32,20,12
2016/9/30,141097,港北区,新吉田東二丁目,41,24,12,12
2016/9/30,141097,港北区,新吉田東二丁目,42,44,22,22
2016/9/30,141097,港北区,新吉田東二丁目,43,43,20,23
2016/9/30,141097,港北区,新吉田東二丁目,44,29,20,9
2016/9/30,141097,港北区,新吉田東二丁目,45,37,21,16
2016/9/30,141097,港北区,新吉田東二丁目,46,41,19,22
2016/9/30,141097,港北区,新吉田東二丁目,47,42,20,22
2016/9/30,141097,港北区,新吉田東二丁目,48,28,13,15
2016/9/30,141097,港北区,新吉田東二丁目,49,39,16,23
2016/9/30,141097,港北区,新吉田東二丁目,50,25,14,11
2016/9/30,141097,港北区,新吉田東二丁目,51,35,20,15
2016/9/30,141097,港北区,新吉田東二丁目,52,33,15,18
2016/9/30,141097,港北区,新吉田東二丁目,53,36,20,16
2016/9/30,141097,港北区,新吉田東二丁目,54,21,13,8
2016/9/30,141097,港北区,新吉田東二丁目,55,29,12,17
2016/9/30,141097,港北区,新吉田東二丁目,56,39,10,29
2016/9/30,141097,港北区,新吉田東二丁目,57,27,11,16
2016/9/30,141097,港北区,新吉田東二丁目,58,42,17,25
2016/9/30,141097,港北区,新吉田東二丁目,59,44,18,26
2016/9/30,141097,港北区,新吉田東二丁目,60,38,18,20
2016/9/30,141097,港北区,新吉田東二丁目,61,43,17,26
2016/9/30,141097,港北区,新吉田東二丁目,62,40,22,18
2016/9/30,141097,港北区,新吉田東二丁目,63,34,22,12
2016/9/30,141097,港北区,新吉田東二丁目,64,45,26,19
2016/9/30,141097,港北区,新吉田東二丁目,65,30,11,19
2016/9/30,141097,港北区,新吉田東二丁目,66,38,21,17
2016/9/30,141097,港北区,新吉田東二丁目,67,48,34,14
2016/9/30,141097,港北区,新吉田東二丁目,68,46,23,23
2016/9/30,141097,港北区,新吉田東二丁目,69,37,13,24
2016/9/30,141097,港北区,新吉田東二丁目,70,18,13,5
2016/9/30,141097,港北区,新吉田東二丁目,71,35,15,20
2016/9/30,141097,港北区,新吉田東二丁目,72,30,12,18
2016/9/30,141097,港北区,新吉田東二丁目,73,23,13,10
2016/9/30,141097,港北区,新吉田東二丁目,74,33,15,18
2016/9/30,141097,港北区,新吉田東二丁目,75,23,10,13
2016/9/30,141097,港北区,新吉田東二丁目,76,21,11,10
2016/9/30,141097,港北区,新吉田東二丁目,77,19,11,8
2016/9/30,141097,港北区,新吉田東二丁目,78,21,11,10
2016/9/30,141097,港北区,新吉田東二丁目,79,12,8,4
2016/9/30,141097,港北区,新吉田東二丁目,80,17,5,12
2016/9/30,141097,港北区,新吉田東二丁目,81,9,4,5
2016/9/30,141097,港北区,新吉田東二丁目,82,13,7,6
2016/9/30,141097,港北区,新吉田東二丁目,83,17,5,12
2016/9/30,141097,港北区,新吉田東二丁目,84,17,7,10
2016/9/30,141097,港北区,新吉田東二丁目,85,11,5,6
2016/9/30,141097,港北区,新吉田東二丁目,86,12,4,8
2016/9/30,141097,港北区,新吉田東二丁目,87,5,2,3
2016/9/30,141097,港北区,新吉田東二丁目,88,8,4,4
2016/9/30,141097,港北区,新吉田東二丁目,89,8,3,5
2016/9/30,141097,港北区,新吉田東二丁目,90,8,4,4
2016/9/30,141097,港北区,新吉田東二丁目,91,8,2,6
2016/9/30,141097,港北区,新吉田東二丁目,92,4,2,2
2016/9/30,141097,港北区,新吉田東二丁目,93,0,0,0
2016/9/30,141097,港北区,新吉田東二丁目,94,1,0,1
2016/9/30,141097,港北区,新吉田東二丁目,95,0,0,0
2016/9/30,141097,港北区,新吉田東二丁目,96,2,0,2
2016/9/30,141097,港北区,新吉田東二丁目,97,2,1,1
2016/9/30,141097,港北区,新吉田東二丁目,98,1,1,0
2016/9/30,141097,港北区,新吉田東二丁目,99,1,0,1
2016/9/30,141097,港北区,新吉田東二丁目,100,1,0,1
2016/9/30,141097,港北区,新吉田東三丁目,合計,2438,1211,1227
2016/9/30,141097,港北区,新吉田東三丁目,0,32,10,22
2016/9/30,141097,港北区,新吉田東三丁目,1,43,20,23
2016/9/30,141097,港北区,新吉田東三丁目,2,41,20,21
2016/9/30,141097,港北区,新吉田東三丁目,3,38,18,20
2016/9/30,141097,港北区,新吉田東三丁目,4,30,14,16
2016/9/30,141097,港北区,新吉田東三丁目,5,48,33,15
2016/9/30,141097,港北区,新吉田東三丁目,6,22,9,13
2016/9/30,141097,港北区,新吉田東三丁目,7,35,15,20
2016/9/30,141097,港北区,新吉田東三丁目,8,26,8,18
2016/9/30,141097,港北区,新吉田東三丁目,9,21,8,13
2016/9/30,141097,港北区,新吉田東三丁目,10,23,9,14
2016/9/30,141097,港北区,新吉田東三丁目,11,18,8,10
2016/9/30,141097,港北区,新吉田東三丁目,12,18,7,11
2016/9/30,141097,港北区,新吉田東三丁目,13,13,4,9
2016/9/30,141097,港北区,新吉田東三丁目,14,25,15,10
2016/9/30,141097,港北区,新吉田東三丁目,15,21,9,12
2016/9/30,141097,港北区,新吉田東三丁目,16,18,6,12
2016/9/30,141097,港北区,新吉田東三丁目,17,18,12,6
2016/9/30,141097,港北区,新吉田東三丁目,18,16,6,10
2016/9/30,141097,港北区,新吉田東三丁目,19,16,8,8
2016/9/30,141097,港北区,新吉田東三丁目,20,17,7,10
2016/9/30,141097,港北区,新吉田東三丁目,21,25,10,15
2016/9/30,141097,港北区,新吉田東三丁目,22,21,13,8
2016/9/30,141097,港北区,新吉田東三丁目,23,22,13,9
2016/9/30,141097,港北区,新吉田東三丁目,24,26,13,13
2016/9/30,141097,港北区,新吉田東三丁目,25,24,18,6
2016/9/30,141097,港北区,新吉田東三丁目,26,29,17,12
2016/9/30,141097,港北区,新吉田東三丁目,27,24,13,11
2016/9/30,141097,港北区,新吉田東三丁目,28,32,15,17
2016/9/30,141097,港北区,新吉田東三丁目,29,37,17,20
2016/9/30,141097,港北区,新吉田東三丁目,30,32,21,11
2016/9/30,141097,港北区,新吉田東三丁目,31,48,16,32
2016/9/30,141097,港北区,新吉田東三丁目,32,42,21,21
2016/9/30,141097,港北区,新吉田東三丁目,33,51,27,24
2016/9/30,141097,港北区,新吉田東三丁目,34,53,23,30
2016/9/30,141097,港北区,新吉田東三丁目,35,51,23,28
2016/9/30,141097,港北区,新吉田東三丁目,36,53,32,21
2016/9/30,141097,港北区,新吉田東三丁目,37,49,25,24
2016/9/30,141097,港北区,新吉田東三丁目,38,56,27,29
2016/9/30,141097,港北区,新吉田東三丁目,39,41,18,23
2016/9/30,141097,港北区,新吉田東三丁目,40,47,27,20
2016/9/30,141097,港北区,新吉田東三丁目,41,58,33,25
2016/9/30,141097,港北区,新吉田東三丁目,42,51,26,25
2016/9/30,141097,港北区,新吉田東三丁目,43,52,28,24
2016/9/30,141097,港北区,新吉田東三丁目,44,48,29,19
2016/9/30,141097,港北区,新吉田東三丁目,45,32,16,16
2016/9/30,141097,港北区,新吉田東三丁目,46,47,27,20
2016/9/30,141097,港北区,新吉田東三丁目,47,40,20,20
2016/9/30,141097,港北区,新吉田東三丁目,48,34,19,15
2016/9/30,141097,港北区,新吉田東三丁目,49,31,18,13
2016/9/30,141097,港北区,新吉田東三丁目,50,23,14,9
2016/9/30,141097,港北区,新吉田東三丁目,51,25,12,13
2016/9/30,141097,港北区,新吉田東三丁目,52,27,15,12
2016/9/30,141097,港北区,新吉田東三丁目,53,20,15,5
2016/9/30,141097,港北区,新吉田東三丁目,54,18,11,7
2016/9/30,141097,港北区,新吉田東三丁目,55,22,12,10
2016/9/30,141097,港北区,新吉田東三丁目,56,22,10,12
2016/9/30,141097,港北区,新吉田東三丁目,57,21,9,12
2016/9/30,141097,港北区,新吉田東三丁目,58,26,17,9
2016/9/30,141097,港北区,新吉田東三丁目,59,14,7,7
2016/9/30,141097,港北区,新吉田東三丁目,60,13,5,8
2016/9/30,141097,港北区,新吉田東三丁目,61,17,9,8
2016/9/30,141097,港北区,新吉田東三丁目,62,22,12,10
2016/9/30,141097,港北区,新吉田東三丁目,63,11,3,8
2016/9/30,141097,港北区,新吉田東三丁目,64,21,12,9
2016/9/30,141097,港北区,新吉田東三丁目,65,26,13,13
2016/9/30,141097,港北区,新吉田東三丁目,66,16,8,8
2016/9/30,141097,港北区,新吉田東三丁目,67,35,14,21
2016/9/30,141097,港北区,新吉田東三丁目,68,30,14,16
2016/9/30,141097,港北区,新吉田東三丁目,69,25,12,13
2016/9/30,141097,港北区,新吉田東三丁目,70,23,12,11
2016/9/30,141097,港北区,新吉田東三丁目,71,20,7,13
2016/9/30,141097,港北区,新吉田東三丁目,72,22,10,12
2016/9/30,141097,港北区,新吉田東三丁目,73,29,14,15
2016/9/30,141097,港北区,新吉田東三丁目,74,23,8,15
2016/9/30,141097,港北区,新吉田東三丁目,75,27,16,11
2016/9/30,141097,港北区,新吉田東三丁目,76,16,6,10
2016/9/30,141097,港北区,新吉田東三丁目,77,15,9,6
2016/9/30,141097,港北区,新吉田東三丁目,78,20,11,9
2016/9/30,141097,港北区,新吉田東三丁目,79,15,6,9
2016/9/30,141097,港北区,新吉田東三丁目,80,15,7,8
2016/9/30,141097,港北区,新吉田東三丁目,81,11,6,5
2016/9/30,141097,港北区,新吉田東三丁目,82,14,5,9
2016/9/30,141097,港北区,新吉田東三丁目,83,12,7,5
2016/9/30,141097,港北区,新吉田東三丁目,84,5,1,4
2016/9/30,141097,港北区,新吉田東三丁目,85,5,1,4
2016/9/30,141097,港北区,新吉田東三丁目,86,7,3,4
2016/9/30,141097,港北区,新吉田東三丁目,87,4,0,4
2016/9/30,141097,港北区,新吉田東三丁目,88,5,3,2
2016/9/30,141097,港北区,新吉田東三丁目,89,6,2,4
2016/9/30,141097,港北区,新吉田東三丁目,90,5,1,4
2016/9/30,141097,港北区,新吉田東三丁目,91,2,0,2
2016/9/30,141097,港北区,新吉田東三丁目,92,4,0,4
2016/9/30,141097,港北区,新吉田東三丁目,93,1,0,1
2016/9/30,141097,港北区,新吉田東三丁目,94,1,0,1
2016/9/30,141097,港北区,新吉田東三丁目,95,0,0,0
2016/9/30,141097,港北区,新吉田東三丁目,96,1,1,0
2016/9/30,141097,港北区,新吉田東三丁目,97,0,0,0
2016/9/30,141097,港北区,新吉田東三丁目,98,1,0,1
2016/9/30,141097,港北区,新吉田東三丁目,99,0,0,0
2016/9/30,141097,港北区,新吉田東三丁目,100,0,0,0
2016/9/30,141097,港北区,新吉田東四丁目,合計,1093,572,521
2016/9/30,141097,港北区,新吉田東四丁目,0,11,7,4
2016/9/30,141097,港北区,新吉田東四丁目,1,13,8,5
2016/9/30,141097,港北区,新吉田東四丁目,2,15,10,5
2016/9/30,141097,港北区,新吉田東四丁目,3,10,8,2
2016/9/30,141097,港北区,新吉田東四丁目,4,22,14,8
2016/9/30,141097,港北区,新吉田東四丁目,5,12,8,4
2016/9/30,141097,港北区,新吉田東四丁目,6,15,11,4
2016/9/30,141097,港北区,新吉田東四丁目,7,12,8,4
2016/9/30,141097,港北区,新吉田東四丁目,8,6,2,4
2016/9/30,141097,港北区,新吉田東四丁目,9,16,6,10
2016/9/30,141097,港北区,新吉田東四丁目,10,11,4,7
2016/9/30,141097,港北区,新吉田東四丁目,11,11,3,8
2016/9/30,141097,港北区,新吉田東四丁目,12,9,6,3
2016/9/30,141097,港北区,新吉田東四丁目,13,14,6,8
2016/9/30,141097,港北区,新吉田東四丁目,14,7,1,6
2016/9/30,141097,港北区,新吉田東四丁目,15,11,3,8
2016/9/30,141097,港北区,新吉田東四丁目,16,11,5,6
2016/9/30,141097,港北区,新吉田東四丁目,17,6,5,1
2016/9/30,141097,港北区,新吉田東四丁目,18,11,7,4
2016/9/30,141097,港北区,新吉田東四丁目,19,7,2,5
2016/9/30,141097,港北区,新吉田東四丁目,20,15,11,4
2016/9/30,141097,港北区,新吉田東四丁目,21,8,2,6
2016/9/30,141097,港北区,新吉田東四丁目,22,7,4,3
2016/9/30,141097,港北区,新吉田東四丁目,23,5,3,2
2016/9/30,141097,港北区,新吉田東四丁目,24,8,5,3
2016/9/30,141097,港北区,新吉田東四丁目,25,13,8,5
2016/9/30,141097,港北区,新吉田東四丁目,26,13,10,3
2016/9/30,141097,港北区,新吉田東四丁目,27,14,5,9
2016/9/30,141097,港北区,新吉田東四丁目,28,10,4,6
2016/9/30,141097,港北区,新吉田東四丁目,29,16,8,8
2016/9/30,141097,港北区,新吉田東四丁目,30,15,8,7
2016/9/30,141097,港北区,新吉田東四丁目,31,12,5,7
2016/9/30,141097,港北区,新吉田東四丁目,32,14,10,4
2016/9/30,141097,港北区,新吉田東四丁目,33,17,8,9
2016/9/30,141097,港北区,新吉田東四丁目,34,19,13,6
2016/9/30,141097,港北区,新吉田東四丁目,35,23,13,10
2016/9/30,141097,港北区,新吉田東四丁目,36,18,10,8
2016/9/30,141097,港北区,新吉田東四丁目,37,28,16,12
2016/9/30,141097,港北区,新吉田東四丁目,38,24,10,14
2016/9/30,141097,港北区,新吉田東四丁目,39,19,8,11
2016/9/30,141097,港北区,新吉田東四丁目,40,25,12,13
2016/9/30,141097,港北区,新吉田東四丁目,41,23,12,11
2016/9/30,141097,港北区,新吉田東四丁目,42,17,8,9
2016/9/30,141097,港北区,新吉田東四丁目,43,21,14,7
2016/9/30,141097,港北区,新吉田東四丁目,44,17,10,7
2016/9/30,141097,港北区,新吉田東四丁目,45,18,13,5
2016/9/30,141097,港北区,新吉田東四丁目,46,26,13,13
2016/9/30,141097,港北区,新吉田東四丁目,47,24,17,7
2016/9/30,141097,港北区,新吉田東四丁目,48,14,6,8
2016/9/30,141097,港北区,新吉田東四丁目,49,17,10,7
2016/9/30,141097,港北区,新吉田東四丁目,50,14,8,6
2016/9/30,141097,港北区,新吉田東四丁目,51,11,7,4
2016/9/30,141097,港北区,新吉田東四丁目,52,13,9,4
2016/9/30,141097,港北区,新吉田東四丁目,53,10,8,2
2016/9/30,141097,港北区,新吉田東四丁目,54,14,5,9
2016/9/30,141097,港北区,新吉田東四丁目,55,6,4,2
2016/9/30,141097,港北区,新吉田東四丁目,56,9,6,3
2016/9/30,141097,港北区,新吉田東四丁目,57,6,2,4
2016/9/30,141097,港北区,新吉田東四丁目,58,6,4,2
2016/9/30,141097,港北区,新吉田東四丁目,59,12,2,10
2016/9/30,141097,港北区,新吉田東四丁目,60,10,7,3
2016/9/30,141097,港北区,新吉田東四丁目,61,12,6,6
2016/9/30,141097,港北区,新吉田東四丁目,62,4,1,3
2016/9/30,141097,港北区,新吉田東四丁目,63,7,4,3
2016/9/30,141097,港北区,新吉田東四丁目,64,9,3,6
2016/9/30,141097,港北区,新吉田東四丁目,65,10,4,6
2016/9/30,141097,港北区,新吉田東四丁目,66,15,6,9
2016/9/30,141097,港北区,新吉田東四丁目,67,18,9,9
2016/9/30,141097,港北区,新吉田東四丁目,68,10,4,6
2016/9/30,141097,港北区,新吉田東四丁目,69,16,6,10
2016/9/30,141097,港北区,新吉田東四丁目,70,7,4,3
2016/9/30,141097,港北区,新吉田東四丁目,71,10,5,5
2016/9/30,141097,港北区,新吉田東四丁目,72,11,6,5
2016/9/30,141097,港北区,新吉田東四丁目,73,4,1,3
2016/9/30,141097,港北区,新吉田東四丁目,74,12,5,7
2016/9/30,141097,港北区,新吉田東四丁目,75,11,5,6
2016/9/30,141097,港北区,新吉田東四丁目,76,11,6,5
2016/9/30,141097,港北区,新吉田東四丁目,77,7,3,4
2016/9/30,141097,港北区,新吉田東四丁目,78,6,2,4
2016/9/30,141097,港北区,新吉田東四丁目,79,9,3,6
2016/9/30,141097,港北区,新吉田東四丁目,80,4,3,1
2016/9/30,141097,港北区,新吉田東四丁目,81,4,3,1
2016/9/30,141097,港北区,新吉田東四丁目,82,11,4,7
2016/9/30,141097,港北区,新吉田東四丁目,83,7,4,3
2016/9/30,141097,港北区,新吉田東四丁目,84,6,2,4
2016/9/30,141097,港北区,新吉田東四丁目,85,5,1,4
2016/9/30,141097,港北区,新吉田東四丁目,86,3,1,2
2016/9/30,141097,港北区,新吉田東四丁目,87,4,2,2
2016/9/30,141097,港北区,新吉田東四丁目,88,2,1,1
2016/9/30,141097,港北区,新吉田東四丁目,89,3,2,1
2016/9/30,141097,港北区,新吉田東四丁目,90,1,1,0
2016/9/30,141097,港北区,新吉田東四丁目,91,4,2,2
2016/9/30,141097,港北区,新吉田東四丁目,92,1,0,1
2016/9/30,141097,港北区,新吉田東四丁目,93,4,0,4
2016/9/30,141097,港北区,新吉田東四丁目,94,0,0,0
2016/9/30,141097,港北区,新吉田東四丁目,95,0,0,0
2016/9/30,141097,港北区,新吉田東四丁目,96,2,0,2
2016/9/30,141097,港北区,新吉田東四丁目,97,1,0,1
2016/9/30,141097,港北区,新吉田東四丁目,98,0,0,0
2016/9/30,141097,港北区,新吉田東四丁目,99,1,1,0
2016/9/30,141097,港北区,新吉田東四丁目,100,0,0,0
2016/9/30,141097,港北区,新吉田東五丁目,合計,3555,1777,1778
2016/9/30,141097,港北区,新吉田東五丁目,0,30,17,13
2016/9/30,141097,港北区,新吉田東五丁目,1,34,20,14
2016/9/30,141097,港北区,新吉田東五丁目,2,23,14,9
2016/9/30,141097,港北区,新吉田東五丁目,3,20,12,8
2016/9/30,141097,港北区,新吉田東五丁目,4,26,15,11
2016/9/30,141097,港北区,新吉田東五丁目,5,27,16,11
2016/9/30,141097,港北区,新吉田東五丁目,6,22,8,14
2016/9/30,141097,港北区,新吉田東五丁目,7,24,12,12
2016/9/30,141097,港北区,新吉田東五丁目,8,36,23,13
2016/9/30,141097,港北区,新吉田東五丁目,9,26,12,14
2016/9/30,141097,港北区,新吉田東五丁目,10,36,17,19
2016/9/30,141097,港北区,新吉田東五丁目,11,37,21,16
2016/9/30,141097,港北区,新吉田東五丁目,12,24,13,11
2016/9/30,141097,港北区,新吉田東五丁目,13,33,20,13
2016/9/30,141097,港北区,新吉田東五丁目,14,32,20,12
2016/9/30,141097,港北区,新吉田東五丁目,15,24,12,12
2016/9/30,141097,港北区,新吉田東五丁目,16,31,16,15
2016/9/30,141097,港北区,新吉田東五丁目,17,39,20,19
2016/9/30,141097,港北区,新吉田東五丁目,18,38,17,21
2016/9/30,141097,港北区,新吉田東五丁目,19,39,21,18
2016/9/30,141097,港北区,新吉田東五丁目,20,43,19,24
2016/9/30,141097,港北区,新吉田東五丁目,21,34,16,18
2016/9/30,141097,港北区,新吉田東五丁目,22,44,24,20
2016/9/30,141097,港北区,新吉田東五丁目,23,36,19,17
2016/9/30,141097,港北区,新吉田東五丁目,24,26,14,12
2016/9/30,141097,港北区,新吉田東五丁目,25,39,25,14
2016/9/30,141097,港北区,新吉田東五丁目,26,40,23,17
2016/9/30,141097,港北区,新吉田東五丁目,27,44,26,18
2016/9/30,141097,港北区,新吉田東五丁目,28,35,17,18
2016/9/30,141097,港北区,新吉田東五丁目,29,47,24,23
2016/9/30,141097,港北区,新吉田東五丁目,30,45,27,18
2016/9/30,141097,港北区,新吉田東五丁目,31,40,17,23
2016/9/30,141097,港北区,新吉田東五丁目,32,41,21,20
2016/9/30,141097,港北区,新吉田東五丁目,33,46,24,22
2016/9/30,141097,港北区,新吉田東五丁目,34,44,24,20
2016/9/30,141097,港北区,新吉田東五丁目,35,49,29,20
2016/9/30,141097,港北区,新吉田東五丁目,36,48,24,24
2016/9/30,141097,港北区,新吉田東五丁目,37,48,26,22
2016/9/30,141097,港北区,新吉田東五丁目,38,48,27,21
2016/9/30,141097,港北区,新吉田東五丁目,39,50,25,25
2016/9/30,141097,港北区,新吉田東五丁目,40,49,25,24
2016/9/30,141097,港北区,新吉田東五丁目,41,45,27,18
2016/9/30,141097,港北区,新吉田東五丁目,42,48,19,29
2016/9/30,141097,港北区,新吉田東五丁目,43,62,32,30
2016/9/30,141097,港北区,新吉田東五丁目,44,71,35,36
2016/9/30,141097,港北区,新吉田東五丁目,45,50,22,28
2016/9/30,141097,港北区,新吉田東五丁目,46,54,26,28
2016/9/30,141097,港北区,新吉田東五丁目,47,49,27,22
2016/9/30,141097,港北区,新吉田東五丁目,48,56,26,30
2016/9/30,141097,港北区,新吉田東五丁目,49,59,36,23
2016/9/30,141097,港北区,新吉田東五丁目,50,49,25,24
2016/9/30,141097,港北区,新吉田東五丁目,51,54,21,33
2016/9/30,141097,港北区,新吉田東五丁目,52,39,19,20
2016/9/30,141097,港北区,新吉田東五丁目,53,49,33,16
2016/9/30,141097,港北区,新吉田東五丁目,54,47,27,20
2016/9/30,141097,港北区,新吉田東五丁目,55,49,23,26
2016/9/30,141097,港北区,新吉田東五丁目,56,45,25,20
2016/9/30,141097,港北区,新吉田東五丁目,57,38,17,21
2016/9/30,141097,港北区,新吉田東五丁目,58,41,16,25
2016/9/30,141097,港北区,新吉田東五丁目,59,37,17,20
2016/9/30,141097,港北区,新吉田東五丁目,60,43,23,20
2016/9/30,141097,港北区,新吉田東五丁目,61,35,20,15
2016/9/30,141097,港北区,新吉田東五丁目,62,29,15,14
2016/9/30,141097,港北区,新吉田東五丁目,63,38,12,26
2016/9/30,141097,港北区,新吉田東五丁目,64,36,17,19
2016/9/30,141097,港北区,新吉田東五丁目,65,44,19,25
2016/9/30,141097,港北区,新吉田東五丁目,66,49,26,23
2016/9/30,141097,港北区,新吉田東五丁目,67,58,30,28
2016/9/30,141097,港北区,新吉田東五丁目,68,59,28,31
2016/9/30,141097,港北区,新吉田東五丁目,69,56,25,31
2016/9/30,141097,港北区,新吉田東五丁目,70,32,14,18
2016/9/30,141097,港北区,新吉田東五丁目,71,50,24,26
2016/9/30,141097,港北区,新吉田東五丁目,72,48,21,27
2016/9/30,141097,港北区,新吉田東五丁目,73,44,22,22
2016/9/30,141097,港北区,新吉田東五丁目,74,36,15,21
2016/9/30,141097,港北区,新吉田東五丁目,75,47,26,21
2016/9/30,141097,港北区,新吉田東五丁目,76,36,19,17
2016/9/30,141097,港北区,新吉田東五丁目,77,35,17,18
2016/9/30,141097,港北区,新吉田東五丁目,78,35,14,21
2016/9/30,141097,港北区,新吉田東五丁目,79,32,11,21
2016/9/30,141097,港北区,新吉田東五丁目,80,36,22,14
2016/9/30,141097,港北区,新吉田東五丁目,81,26,12,14
2016/9/30,141097,港北区,新吉田東五丁目,82,24,10,14
2016/9/30,141097,港北区,新吉田東五丁目,83,19,8,11
2016/9/30,141097,港北区,新吉田東五丁目,84,29,10,19
2016/9/30,141097,港北区,新吉田東五丁目,85,18,5,13
2016/9/30,141097,港北区,新吉田東五丁目,86,16,6,10
2016/9/30,141097,港北区,新吉田東五丁目,87,24,8,16
2016/9/30,141097,港北区,新吉田東五丁目,88,13,4,9
2016/9/30,141097,港北区,新吉田東五丁目,89,6,3,3
2016/9/30,141097,港北区,新吉田東五丁目,90,16,8,8
2016/9/30,141097,港北区,新吉田東五丁目,91,13,2,11
2016/9/30,141097,港北区,新吉田東五丁目,92,7,0,7
2016/9/30,141097,港北区,新吉田東五丁目,93,6,1,5
2016/9/30,141097,港北区,新吉田東五丁目,94,8,3,5
2016/9/30,141097,港北区,新吉田東五丁目,95,5,2,3
2016/9/30,141097,港北区,新吉田東五丁目,96,4,0,4
2016/9/30,141097,港北区,新吉田東五丁目,97,2,0,2
2016/9/30,141097,港北区,新吉田東五丁目,98,1,0,1
2016/9/30,141097,港北区,新吉田東五丁目,99,0,0,0
2016/9/30,141097,港北区,新吉田東五丁目,100,1,0,1
2016/9/30,141097,港北区,新吉田東六丁目,合計,4097,2056,2041
2016/9/30,141097,港北区,新吉田東六丁目,0,26,17,9
2016/9/30,141097,港北区,新吉田東六丁目,1,33,13,20
2016/9/30,141097,港北区,新吉田東六丁目,2,37,15,22
2016/9/30,141097,港北区,新吉田東六丁目,3,33,14,19
2016/9/30,141097,港北区,新吉田東六丁目,4,27,14,13
2016/9/30,141097,港北区,新吉田東六丁目,5,34,12,22
2016/9/30,141097,港北区,新吉田東六丁目,6,24,10,14
2016/9/30,141097,港北区,新吉田東六丁目,7,30,18,12
2016/9/30,141097,港北区,新吉田東六丁目,8,43,24,19
2016/9/30,141097,港北区,新吉田東六丁目,9,31,14,17
2016/9/30,141097,港北区,新吉田東六丁目,10,32,19,13
2016/9/30,141097,港北区,新吉田東六丁目,11,37,20,17
2016/9/30,141097,港北区,新吉田東六丁目,12,49,26,23
2016/9/30,141097,港北区,新吉田東六丁目,13,33,16,17
2016/9/30,141097,港北区,新吉田東六丁目,14,35,19,16
2016/9/30,141097,港北区,新吉田東六丁目,15,38,21,17
2016/9/30,141097,港北区,新吉田東六丁目,16,37,22,15
2016/9/30,141097,港北区,新吉田東六丁目,17,44,23,21
2016/9/30,141097,港北区,新吉田東六丁目,18,36,19,17
2016/9/30,141097,港北区,新吉田東六丁目,19,39,19,20
2016/9/30,141097,港北区,新吉田東六丁目,20,38,19,19
2016/9/30,141097,港北区,新吉田東六丁目,21,34,15,19
2016/9/30,141097,港北区,新吉田東六丁目,22,52,21,31
2016/9/30,141097,港北区,新吉田東六丁目,23,46,20,26
2016/9/30,141097,港北区,新吉田東六丁目,24,34,16,18
2016/9/30,141097,港北区,新吉田東六丁目,25,36,16,20
2016/9/30,141097,港北区,新吉田東六丁目,26,51,30,21
2016/9/30,141097,港北区,新吉田東六丁目,27,64,35,29
2016/9/30,141097,港北区,新吉田東六丁目,28,49,30,19
2016/9/30,141097,港北区,新吉田東六丁目,29,50,26,24
2016/9/30,141097,港北区,新吉田東六丁目,30,44,29,15
2016/9/30,141097,港北区,新吉田東六丁目,31,47,26,21
2016/9/30,141097,港北区,新吉田東六丁目,32,41,21,20
2016/9/30,141097,港北区,新吉田東六丁目,33,38,25,13
2016/9/30,141097,港北区,新吉田東六丁目,34,55,27,28
2016/9/30,141097,港北区,新吉田東六丁目,35,49,31,18
2016/9/30,141097,港北区,新吉田東六丁目,36,45,24,21
2016/9/30,141097,港北区,新吉田東六丁目,37,52,31,21
2016/9/30,141097,港北区,新吉田東六丁目,38,47,23,24
2016/9/30,141097,港北区,新吉田東六丁目,39,64,31,33
2016/9/30,141097,港北区,新吉田東六丁目,40,54,23,31
2016/9/30,141097,港北区,新吉田東六丁目,41,70,43,27
2016/9/30,141097,港北区,新吉田東六丁目,42,80,45,35
2016/9/30,141097,港北区,新吉田東六丁目,43,77,38,39
2016/9/30,141097,港北区,新吉田東六丁目,44,58,31,27
2016/9/30,141097,港北区,新吉田東六丁目,45,78,40,38
2016/9/30,141097,港北区,新吉田東六丁目,46,76,39,37
2016/9/30,141097,港北区,新吉田東六丁目,47,61,32,29
2016/9/30,141097,港北区,新吉田東六丁目,48,77,41,36
2016/9/30,141097,港北区,新吉田東六丁目,49,61,37,24
2016/9/30,141097,港北区,新吉田東六丁目,50,52,32,20
2016/9/30,141097,港北区,新吉田東六丁目,51,57,32,25
2016/9/30,141097,港北区,新吉田東六丁目,52,56,28,28
2016/9/30,141097,港北区,新吉田東六丁目,53,46,22,24
2016/9/30,141097,港北区,新吉田東六丁目,54,40,22,18
2016/9/30,141097,港北区,新吉田東六丁目,55,48,25,23
2016/9/30,141097,港北区,新吉田東六丁目,56,38,20,18
2016/9/30,141097,港北区,新吉田東六丁目,57,28,20,8
2016/9/30,141097,港北区,新吉田東六丁目,58,36,17,19
2016/9/30,141097,港北区,新吉田東六丁目,59,41,20,21
2016/9/30,141097,港北区,新吉田東六丁目,60,34,15,19
2016/9/30,141097,港北区,新吉田東六丁目,61,36,20,16
2016/9/30,141097,港北区,新吉田東六丁目,62,45,24,21
2016/9/30,141097,港北区,新吉田東六丁目,63,45,22,23
2016/9/30,141097,港北区,新吉田東六丁目,64,44,20,24
2016/9/30,141097,港北区,新吉田東六丁目,65,49,15,34
2016/9/30,141097,港北区,新吉田東六丁目,66,50,18,32
2016/9/30,141097,港北区,新吉田東六丁目,67,66,35,31
2016/9/30,141097,港北区,新吉田東六丁目,68,59,28,31
2016/9/30,141097,港北区,新吉田東六丁目,69,63,23,40
2016/9/30,141097,港北区,新吉田東六丁目,70,32,14,18
2016/9/30,141097,港北区,新吉田東六丁目,71,55,35,20
2016/9/30,141097,港北区,新吉田東六丁目,72,65,30,35
2016/9/30,141097,港北区,新吉田東六丁目,73,68,36,32
2016/9/30,141097,港北区,新吉田東六丁目,74,59,28,31
2016/9/30,141097,港北区,新吉田東六丁目,75,61,26,35
2016/9/30,141097,港北区,新吉田東六丁目,76,57,19,38
2016/9/30,141097,港北区,新吉田東六丁目,77,42,21,21
2016/9/30,141097,港北区,新吉田東六丁目,78,45,19,26
2016/9/30,141097,港北区,新吉田東六丁目,79,38,20,18
2016/9/30,141097,港北区,新吉田東六丁目,80,50,18,32
2016/9/30,141097,港北区,新吉田東六丁目,81,41,27,14
2016/9/30,141097,港北区,新吉田東六丁目,82,33,12,21
2016/9/30,141097,港北区,新吉田東六丁目,83,19,10,9
2016/9/30,141097,港北区,新吉田東六丁目,84,30,7,23
2016/9/30,141097,港北区,新吉田東六丁目,85,28,11,17
2016/9/30,141097,港北区,新吉田東六丁目,86,23,6,17
2016/9/30,141097,港北区,新吉田東六丁目,87,18,7,11
2016/9/30,141097,港北区,新吉田東六丁目,88,9,2,7
2016/9/30,141097,港北区,新吉田東六丁目,89,20,12,8
2016/9/30,141097,港北区,新吉田東六丁目,90,10,7,3
2016/9/30,141097,港北区,新吉田東六丁目,91,10,4,6
2016/9/30,141097,港北区,新吉田東六丁目,92,8,3,5
2016/9/30,141097,港北区,新吉田東六丁目,93,3,1,2
2016/9/30,141097,港北区,新吉田東六丁目,94,9,2,7
2016/9/30,141097,港北区,新吉田東六丁目,95,0,0,0
2016/9/30,141097,港北区,新吉田東六丁目,96,2,1,1
2016/9/30,141097,港北区,新吉田東六丁目,97,3,0,3
2016/9/30,141097,港北区,新吉田東六丁目,98,0,0,0
2016/9/30,141097,港北区,新吉田東六丁目,99,0,0,0
2016/9/30,141097,港北区,新吉田東六丁目,100,0,0,0
2016/9/30,141097,港北区,新吉田東七丁目,合計,1420,705,715
2016/9/30,141097,港北区,新吉田東七丁目,0,8,5,3
2016/9/30,141097,港北区,新吉田東七丁目,1,8,3,5
2016/9/30,141097,港北区,新吉田東七丁目,2,11,4,7
2016/9/30,141097,港北区,新吉田東七丁目,3,14,8,6
2016/9/30,141097,港北区,新吉田東七丁目,4,15,7,8
2016/9/30,141097,港北区,新吉田東七丁目,5,11,9,2
2016/9/30,141097,港北区,新吉田東七丁目,6,13,6,7
2016/9/30,141097,港北区,新吉田東七丁目,7,10,4,6
2016/9/30,141097,港北区,新吉田東七丁目,8,12,3,9
2016/9/30,141097,港北区,新吉田東七丁目,9,10,4,6
2016/9/30,141097,港北区,新吉田東七丁目,10,9,5,4
2016/9/30,141097,港北区,新吉田東七丁目,11,14,7,7
2016/9/30,141097,港北区,新吉田東七丁目,12,7,2,5
2016/9/30,141097,港北区,新吉田東七丁目,13,15,6,9
2016/9/30,141097,港北区,新吉田東七丁目,14,6,0,6
2016/9/30,141097,港北区,新吉田東七丁目,15,13,8,5
2016/9/30,141097,港北区,新吉田東七丁目,16,11,7,4
2016/9/30,141097,港北区,新吉田東七丁目,17,10,8,2
2016/9/30,141097,港北区,新吉田東七丁目,18,19,13,6
2016/9/30,141097,港北区,新吉田東七丁目,19,14,5,9
2016/9/30,141097,港北区,新吉田東七丁目,20,13,10,3
2016/9/30,141097,港北区,新吉田東七丁目,21,13,4,9
2016/9/30,141097,港北区,新吉田東七丁目,22,13,7,6
2016/9/30,141097,港北区,新吉田東七丁目,23,11,7,4
2016/9/30,141097,港北区,新吉田東七丁目,24,18,14,4
2016/9/30,141097,港北区,新吉田東七丁目,25,5,4,1
2016/9/30,141097,港北区,新吉田東七丁目,26,12,6,6
2016/9/30,141097,港北区,新吉田東七丁目,27,14,8,6
2016/9/30,141097,港北区,新吉田東七丁目,28,8,6,2
2016/9/30,141097,港北区,新吉田東七丁目,29,18,9,9
2016/9/30,141097,港北区,新吉田東七丁目,30,15,8,7
2016/9/30,141097,港北区,新吉田東七丁目,31,14,7,7
2016/9/30,141097,港北区,新吉田東七丁目,32,25,11,14
2016/9/30,141097,港北区,新吉田東七丁目,33,13,8,5
2016/9/30,141097,港北区,新吉田東七丁目,34,14,5,9
2016/9/30,141097,港北区,新吉田東七丁目,35,12,9,3
2016/9/30,141097,港北区,新吉田東七丁目,36,23,16,7
2016/9/30,141097,港北区,新吉田東七丁目,37,21,7,14
2016/9/30,141097,港北区,新吉田東七丁目,38,21,10,11
2016/9/30,141097,港北区,新吉田東七丁目,39,21,13,8
2016/9/30,141097,港北区,新吉田東七丁目,40,14,7,7
2016/9/30,141097,港北区,新吉田東七丁目,41,20,12,8
2016/9/30,141097,港北区,新吉田東七丁目,42,36,20,16
2016/9/30,141097,港北区,新吉田東七丁目,43,19,9,10
2016/9/30,141097,港北区,新吉田東七丁目,44,34,18,16
2016/9/30,141097,港北区,新吉田東七丁目,45,29,14,15
2016/9/30,141097,港北区,新吉田東七丁目,46,16,7,9
2016/9/30,141097,港北区,新吉田東七丁目,47,21,4,17
2016/9/30,141097,港北区,新吉田東七丁目,48,24,16,8
2016/9/30,141097,港北区,新吉田東七丁目,49,23,11,12
2016/9/30,141097,港北区,新吉田東七丁目,50,18,10,8
2016/9/30,141097,港北区,新吉田東七丁目,51,32,23,9
2016/9/30,141097,港北区,新吉田東七丁目,52,22,12,10
2016/9/30,141097,港北区,新吉田東七丁目,53,8,3,5
2016/9/30,141097,港北区,新吉田東七丁目,54,15,6,9
2016/9/30,141097,港北区,新吉田東七丁目,55,14,8,6
2016/9/30,141097,港北区,新吉田東七丁目,56,20,6,14
2016/9/30,141097,港北区,新吉田東七丁目,57,14,6,8
2016/9/30,141097,港北区,新吉田東七丁目,58,15,8,7
2016/9/30,141097,港北区,新吉田東七丁目,59,9,4,5
2016/9/30,141097,港北区,新吉田東七丁目,60,13,9,4
2016/9/30,141097,港北区,新吉田東七丁目,61,18,7,11
2016/9/30,141097,港北区,新吉田東七丁目,62,16,10,6
2016/9/30,141097,港北区,新吉田東七丁目,63,14,6,8
2016/9/30,141097,港北区,新吉田東七丁目,64,15,7,8
2016/9/30,141097,港北区,新吉田東七丁目,65,22,3,19
2016/9/30,141097,港北区,新吉田東七丁目,66,17,12,5
2016/9/30,141097,港北区,新吉田東七丁目,67,21,10,11
2016/9/30,141097,港北区,新吉田東七丁目,68,28,14,14
2016/9/30,141097,港北区,新吉田東七丁目,69,24,11,13
2016/9/30,141097,港北区,新吉田東七丁目,70,23,7,16
2016/9/30,141097,港北区,新吉田東七丁目,71,15,7,8
2016/9/30,141097,港北区,新吉田東七丁目,72,25,15,10
2016/9/30,141097,港北区,新吉田東七丁目,73,19,12,7
2016/9/30,141097,港北区,新吉田東七丁目,74,21,10,11
2016/9/30,141097,港北区,新吉田東七丁目,75,21,8,13
2016/9/30,141097,港北区,新吉田東七丁目,76,18,11,7
2016/9/30,141097,港北区,新吉田東七丁目,77,12,7,5
2016/9/30,141097,港北区,新吉田東七丁目,78,18,8,10
2016/9/30,141097,港北区,新吉田東七丁目,79,16,8,8
2016/9/30,141097,港北区,新吉田東七丁目,80,12,3,9
2016/9/30,141097,港北区,新吉田東七丁目,81,13,5,8
2016/9/30,141097,港北区,新吉田東七丁目,82,8,5,3
2016/9/30,141097,港北区,新吉田東七丁目,83,16,7,9
2016/9/30,141097,港北区,新吉田東七丁目,84,8,2,6
2016/9/30,141097,港北区,新吉田東七丁目,85,7,3,4
2016/9/30,141097,港北区,新吉田東七丁目,86,9,2,7
2016/9/30,141097,港北区,新吉田東七丁目,87,6,2,4
2016/9/30,141097,港北区,新吉田東七丁目,88,5,1,4
2016/9/30,141097,港北区,新吉田東七丁目,89,5,3,2
2016/9/30,141097,港北区,新吉田東七丁目,90,1,1,0
2016/9/30,141097,港北区,新吉田東七丁目,91,5,0,5
2016/9/30,141097,港北区,新吉田東七丁目,92,2,1,1
2016/9/30,141097,港北区,新吉田東七丁目,93,3,0,3
2016/9/30,141097,港北区,新吉田東七丁目,94,0,0,0
2016/9/30,141097,港北区,新吉田東七丁目,95,3,0,3
2016/9/30,141097,港北区,新吉田東七丁目,96,0,0,0
2016/9/30,141097,港北区,新吉田東七丁目,97,1,0,1
2016/9/30,141097,港北区,新吉田東七丁目,98,1,0,1
2016/9/30,141097,港北区,新吉田東七丁目,99,0,0,0
2016/9/30,141097,港北区,新吉田東七丁目,100,2,1,1
2016/9/30,141097,港北区,新吉田東八丁目,合計,5539,2858,2681
2016/9/30,141097,港北区,新吉田東八丁目,0,52,25,27
2016/9/30,141097,港北区,新吉田東八丁目,1,53,25,28
2016/9/30,141097,港北区,新吉田東八丁目,2,70,37,33
2016/9/30,141097,港北区,新吉田東八丁目,3,69,31,38
2016/9/30,141097,港北区,新吉田東八丁目,4,67,39,28
2016/9/30,141097,港北区,新吉田東八丁目,5,77,40,37
2016/9/30,141097,港北区,新吉田東八丁目,6,78,39,39
2016/9/30,141097,港北区,新吉田東八丁目,7,67,34,33
2016/9/30,141097,港北区,新吉田東八丁目,8,69,34,35
2016/9/30,141097,港北区,新吉田東八丁目,9,67,38,29
2016/9/30,141097,港北区,新吉田東八丁目,10,67,40,27
2016/9/30,141097,港北区,新吉田東八丁目,11,63,20,43
2016/9/30,141097,港北区,新吉田東八丁目,12,65,38,27
2016/9/30,141097,港北区,新吉田東八丁目,13,64,26,38
2016/9/30,141097,港北区,新吉田東八丁目,14,61,30,31
2016/9/30,141097,港北区,新吉田東八丁目,15,66,36,30
2016/9/30,141097,港北区,新吉田東八丁目,16,63,35,28
2016/9/30,141097,港北区,新吉田東八丁目,17,51,26,25
2016/9/30,141097,港北区,新吉田東八丁目,18,56,24,32
2016/9/30,141097,港北区,新吉田東八丁目,19,61,24,37
2016/9/30,141097,港北区,新吉田東八丁目,20,51,30,21
2016/9/30,141097,港北区,新吉田東八丁目,21,57,33,24
2016/9/30,141097,港北区,新吉田東八丁目,22,60,33,27
2016/9/30,141097,港北区,新吉田東八丁目,23,68,38,30
2016/9/30,141097,港北区,新吉田東八丁目,24,48,24,24
2016/9/30,141097,港北区,新吉田東八丁目,25,72,49,23
2016/9/30,141097,港北区,新吉田東八丁目,26,51,26,25
2016/9/30,141097,港北区,新吉田東八丁目,27,56,31,25
2016/9/30,141097,港北区,新吉田東八丁目,28,70,43,27
2016/9/30,141097,港北区,新吉田東八丁目,29,51,23,28
2016/9/30,141097,港北区,新吉田東八丁目,30,52,27,25
2016/9/30,141097,港北区,新吉田東八丁目,31,71,36,35
2016/9/30,141097,港北区,新吉田東八丁目,32,80,43,37
2016/9/30,141097,港北区,新吉田東八丁目,33,91,43,48
2016/9/30,141097,港北区,新吉田東八丁目,34,81,36,45
2016/9/30,141097,港北区,新吉田東八丁目,35,82,41,41
2016/9/30,141097,港北区,新吉田東八丁目,36,82,41,41
2016/9/30,141097,港北区,新吉田東八丁目,37,105,62,43
2016/9/30,141097,港北区,新吉田東八丁目,38,110,57,53
2016/9/30,141097,港北区,新吉田東八丁目,39,120,59,61
2016/9/30,141097,港北区,新吉田東八丁目,40,111,63,48
2016/9/30,141097,港北区,新吉田東八丁目,41,103,46,57
2016/9/30,141097,港北区,新吉田東八丁目,42,113,52,61
2016/9/30,141097,港北区,新吉田東八丁目,43,105,56,49
2016/9/30,141097,港北区,新吉田東八丁目,44,126,65,61
2016/9/30,141097,港北区,新吉田東八丁目,45,132,68,64
2016/9/30,141097,港北区,新吉田東八丁目,46,104,58,46
2016/9/30,141097,港北区,新吉田東八丁目,47,108,55,53
2016/9/30,141097,港北区,新吉田東八丁目,48,127,71,56
2016/9/30,141097,港北区,新吉田東八丁目,49,112,60,52
2016/9/30,141097,港北区,新吉田東八丁目,50,71,40,31
2016/9/30,141097,港北区,新吉田東八丁目,51,110,65,45
2016/9/30,141097,港北区,新吉田東八丁目,52,85,46,39
2016/9/30,141097,港北区,新吉田東八丁目,53,56,36,20
2016/9/30,141097,港北区,新吉田東八丁目,54,82,42,40
2016/9/30,141097,港北区,新吉田東八丁目,55,77,43,34
2016/9/30,141097,港北区,新吉田東八丁目,56,65,36,29
2016/9/30,141097,港北区,新吉田東八丁目,57,62,39,23
2016/9/30,141097,港北区,新吉田東八丁目,58,43,20,23
2016/9/30,141097,港北区,新吉田東八丁目,59,41,24,17
2016/9/30,141097,港北区,新吉田東八丁目,60,44,21,23
2016/9/30,141097,港北区,新吉田東八丁目,61,37,15,22
2016/9/30,141097,港北区,新吉田東八丁目,62,43,20,23
2016/9/30,141097,港北区,新吉田東八丁目,63,53,25,28
2016/9/30,141097,港北区,新吉田東八丁目,64,37,17,20
2016/9/30,141097,港北区,新吉田東八丁目,65,51,28,23
2016/9/30,141097,港北区,新吉田東八丁目,66,48,23,25
2016/9/30,141097,港北区,新吉田東八丁目,67,54,26,28
2016/9/30,141097,港北区,新吉田東八丁目,68,53,28,25
2016/9/30,141097,港北区,新吉田東八丁目,69,45,23,22
2016/9/30,141097,港北区,新吉田東八丁目,70,37,21,16
2016/9/30,141097,港北区,新吉田東八丁目,71,37,17,20
2016/9/30,141097,港北区,新吉田東八丁目,72,47,21,26
2016/9/30,141097,港北区,新吉田東八丁目,73,31,18,13
2016/9/30,141097,港北区,新吉田東八丁目,74,40,18,22
2016/9/30,141097,港北区,新吉田東八丁目,75,41,21,20
2016/9/30,141097,港北区,新吉田東八丁目,76,34,8,26
2016/9/30,141097,港北区,新吉田東八丁目,77,23,11,12
2016/9/30,141097,港北区,新吉田東八丁目,78,25,15,10
2016/9/30,141097,港北区,新吉田東八丁目,79,17,11,6
2016/9/30,141097,港北区,新吉田東八丁目,80,24,12,12
2016/9/30,141097,港北区,新吉田東八丁目,81,30,19,11
2016/9/30,141097,港北区,新吉田東八丁目,82,17,6,11
2016/9/30,141097,港北区,新吉田東八丁目,83,17,8,9
2016/9/30,141097,港北区,新吉田東八丁目,84,11,3,8
2016/9/30,141097,港北区,新吉田東八丁目,85,8,4,4
2016/9/30,141097,港北区,新吉田東八丁目,86,12,3,9
2016/9/30,141097,港北区,新吉田東八丁目,87,8,4,4
2016/9/30,141097,港北区,新吉田東八丁目,88,10,4,6
2016/9/30,141097,港北区,新吉田東八丁目,89,5,1,4
2016/9/30,141097,港北区,新吉田東八丁目,90,9,2,7
2016/9/30,141097,港北区,新吉田東八丁目,91,4,1,3
2016/9/30,141097,港北区,新吉田東八丁目,92,3,1,2
2016/9/30,141097,港北区,新吉田東八丁目,93,3,2,1
2016/9/30,141097,港北区,新吉田東八丁目,94,0,0,0
2016/9/30,141097,港北区,新吉田東八丁目,95,0,0,0
2016/9/30,141097,港北区,新吉田東八丁目,96,1,0,1
2016/9/30,141097,港北区,新吉田東八丁目,97,0,0,0
2016/9/30,141097,港北区,新吉田東八丁目,98,2,0,2
2016/9/30,141097,港北区,新吉田東八丁目,99,0,0,0
2016/9/30,141097,港北区,新吉田東八丁目,100,1,0,1
2016/9/30,141097,港北区,北新横浜一丁目,合計,206,119,87
2016/9/30,141097,港北区,北新横浜一丁目,0,7,5,2
2016/9/30,141097,港北区,北新横浜一丁目,1,5,3,2
2016/9/30,141097,港北区,北新横浜一丁目,2,3,2,1
2016/9/30,141097,港北区,北新横浜一丁目,3,2,1,1
2016/9/30,141097,港北区,北新横浜一丁目,4,2,1,1
2016/9/30,141097,港北区,北新横浜一丁目,5,2,1,1
2016/9/30,141097,港北区,北新横浜一丁目,6,2,2,0
2016/9/30,141097,港北区,北新横浜一丁目,7,0,0,0
2016/9/30,141097,港北区,北新横浜一丁目,8,1,0,1
2016/9/30,141097,港北区,北新横浜一丁目,9,0,0,0
2016/9/30,141097,港北区,北新横浜一丁目,10,1,0,1
2016/9/30,141097,港北区,北新横浜一丁目,11,0,0,0
2016/9/30,141097,港北区,北新横浜一丁目,12,0,0,0
2016/9/30,141097,港北区,北新横浜一丁目,13,0,0,0
2016/9/30,141097,港北区,北新横浜一丁目,14,0,0,0
2016/9/30,141097,港北区,北新横浜一丁目,15,0,0,0
2016/9/30,141097,港北区,北新横浜一丁目,16,1,0,1
2016/9/30,141097,港北区,北新横浜一丁目,17,0,0,0
2016/9/30,141097,港北区,北新横浜一丁目,18,0,0,0
2016/9/30,141097,港北区,北新横浜一丁目,19,0,0,0
2016/9/30,141097,港北区,北新横浜一丁目,20,0,0,0
2016/9/30,141097,港北区,北新横浜一丁目,21,1,1,0
2016/9/30,141097,港北区,北新横浜一丁目,22,5,4,1
2016/9/30,141097,港北区,北新横浜一丁目,23,3,1,2
2016/9/30,141097,港北区,北新横浜一丁目,24,5,2,3
2016/9/30,141097,港北区,北新横浜一丁目,25,1,1,0
2016/9/30,141097,港北区,北新横浜一丁目,26,3,1,2
2016/9/30,141097,港北区,北新横浜一丁目,27,3,2,1
2016/9/30,141097,港北区,北新横浜一丁目,28,4,4,0
2016/9/30,141097,港北区,北新横浜一丁目,29,10,4,6
2016/9/30,141097,港北区,北新横浜一丁目,30,5,2,3
2016/9/30,141097,港北区,北新横浜一丁目,31,5,1,4
2016/9/30,141097,港北区,北新横浜一丁目,32,8,6,2
2016/9/30,141097,港北区,北新横浜一丁目,33,2,2,0
2016/9/30,141097,港北区,北新横浜一丁目,34,10,5,5
2016/9/30,141097,港北区,北新横浜一丁目,35,8,3,5
2016/9/30,141097,港北区,北新横浜一丁目,36,4,3,1
2016/9/30,141097,港北区,北新横浜一丁目,37,7,3,4
2016/9/30,141097,港北区,北新横浜一丁目,38,9,3,6
2016/9/30,141097,港北区,北新横浜一丁目,39,5,4,1
2016/9/30,141097,港北区,北新横浜一丁目,40,6,3,3
2016/9/30,141097,港北区,北新横浜一丁目,41,10,6,4
2016/9/30,141097,港北区,北新横浜一丁目,42,7,4,3
2016/9/30,141097,港北区,北新横浜一丁目,43,11,7,4
2016/9/30,141097,港北区,北新横浜一丁目,44,8,4,4
2016/9/30,141097,港北区,北新横浜一丁目,45,5,4,1
2016/9/30,141097,港北区,北新横浜一丁目,46,3,1,2
2016/9/30,141097,港北区,北新横浜一丁目,47,3,2,1
2016/9/30,141097,港北区,北新横浜一丁目,48,3,2,1
2016/9/30,141097,港北区,北新横浜一丁目,49,4,4,0
2016/9/30,141097,港北区,北新横浜一丁目,50,2,2,0
2016/9/30,141097,港北区,北新横浜一丁目,51,2,2,0
2016/9/30,141097,港北区,北新横浜一丁目,52,3,2,1
2016/9/30,141097,港北区,北新横浜一丁目,53,0,0,0
2016/9/30,141097,港北区,北新横浜一丁目,54,0,0,0
2016/9/30,141097,港北区,北新横浜一丁目,55,2,2,0
2016/9/30,141097,港北区,北新横浜一丁目,56,0,0,0
2016/9/30,141097,港北区,北新横浜一丁目,57,1,1,0
2016/9/30,141097,港北区,北新横浜一丁目,58,3,3,0
2016/9/30,141097,港北区,北新横浜一丁目,59,0,0,0
2016/9/30,141097,港北区,北新横浜一丁目,60,1,1,0
2016/9/30,141097,港北区,北新横浜一丁目,61,0,0,0
2016/9/30,141097,港北区,北新横浜一丁目,62,0,0,0
2016/9/30,141097,港北区,北新横浜一丁目,63,1,1,0
2016/9/30,141097,港北区,北新横浜一丁目,64,1,0,1
2016/9/30,141097,港北区,北新横浜一丁目,65,0,0,0
2016/9/30,141097,港北区,北新横浜一丁目,66,1,0,1
2016/9/30,141097,港北区,北新横浜一丁目,67,1,0,1
2016/9/30,141097,港北区,北新横浜一丁目,68,0,0,0
2016/9/30,141097,港北区,北新横浜一丁目,69,1,1,0
2016/9/30,141097,港北区,北新横浜一丁目,70,0,0,0
2016/9/30,141097,港北区,北新横浜一丁目,71,0,0,0
2016/9/30,141097,港北区,北新横浜一丁目,72,0,0,0
2016/9/30,141097,港北区,北新横浜一丁目,73,0,0,0
2016/9/30,141097,港北区,北新横浜一丁目,74,0,0,0
2016/9/30,141097,港北区,北新横浜一丁目,75,0,0,0
2016/9/30,141097,港北区,北新横浜一丁目,76,0,0,0
2016/9/30,141097,港北区,北新横浜一丁目,77,0,0,0
2016/9/30,141097,港北区,北新横浜一丁目,78,2,0,2
2016/9/30,141097,港北区,北新横浜一丁目,79,0,0,0
2016/9/30,141097,港北区,北新横浜一丁目,80,1,0,1
2016/9/30,141097,港北区,北新横浜一丁目,81,0,0,0
2016/9/30,141097,港北区,北新横浜一丁目,82,0,0,0
2016/9/30,141097,港北区,北新横浜一丁目,83,0,0,0
2016/9/30,141097,港北区,北新横浜一丁目,84,0,0,0
2016/9/30,141097,港北区,北新横浜一丁目,85,0,0,0
2016/9/30,141097,港北区,北新横浜一丁目,86,0,0,0
2016/9/30,141097,港北区,北新横浜一丁目,87,0,0,0
2016/9/30,141097,港北区,北新横浜一丁目,88,0,0,0
2016/9/30,141097,港北区,北新横浜一丁目,89,0,0,0
2016/9/30,141097,港北区,北新横浜一丁目,90,0,0,0
2016/9/30,141097,港北区,北新横浜一丁目,91,0,0,0
2016/9/30,141097,港北区,北新横浜一丁目,92,0,0,0
2016/9/30,141097,港北区,北新横浜一丁目,93,0,0,0
2016/9/30,141097,港北区,北新横浜一丁目,94,0,0,0
2016/9/30,141097,港北区,北新横浜一丁目,95,0,0,0
2016/9/30,141097,港北区,北新横浜一丁目,96,0,0,0
2016/9/30,141097,港北区,北新横浜一丁目,97,0,0,0
2016/9/30,141097,港北区,北新横浜一丁目,98,0,0,0
2016/9/30,141097,港北区,北新横浜一丁目,99,0,0,0
2016/9/30,141097,港北区,北新横浜一丁目,100,0,0,0
2016/9/30,141097,港北区,北新横浜二丁目,合計,717,344,373
2016/9/30,141097,港北区,北新横浜二丁目,0,16,11,5
2016/9/30,141097,港北区,北新横浜二丁目,1,15,7,8
2016/9/30,141097,港北区,北新横浜二丁目,2,18,8,10
2016/9/30,141097,港北区,北新横浜二丁目,3,10,4,6
2016/9/30,141097,港北区,北新横浜二丁目,4,13,7,6
2016/9/30,141097,港北区,北新横浜二丁目,5,12,9,3
2016/9/30,141097,港北区,北新横浜二丁目,6,7,5,2
2016/9/30,141097,港北区,北新横浜二丁目,7,13,4,9
2016/9/30,141097,港北区,北新横浜二丁目,8,5,3,2
2016/9/30,141097,港北区,北新横浜二丁目,9,5,3,2
2016/9/30,141097,港北区,北新横浜二丁目,10,6,2,4
2016/9/30,141097,港北区,北新横浜二丁目,11,11,5,6
2016/9/30,141097,港北区,北新横浜二丁目,12,7,4,3
2016/9/30,141097,港北区,北新横浜二丁目,13,8,5,3
2016/9/30,141097,港北区,北新横浜二丁目,14,3,1,2
2016/9/30,141097,港北区,北新横浜二丁目,15,2,2,0
2016/9/30,141097,港北区,北新横浜二丁目,16,4,2,2
2016/9/30,141097,港北区,北新横浜二丁目,17,3,1,2
2016/9/30,141097,港北区,北新横浜二丁目,18,3,2,1
2016/9/30,141097,港北区,北新横浜二丁目,19,2,2,0
2016/9/30,141097,港北区,北新横浜二丁目,20,1,1,0
2016/9/30,141097,港北区,北新横浜二丁目,21,4,3,1
2016/9/30,141097,港北区,北新横浜二丁目,22,0,0,0
2016/9/30,141097,港北区,北新横浜二丁目,23,2,1,1
2016/9/30,141097,港北区,北新横浜二丁目,24,3,1,2
2016/9/30,141097,港北区,北新横浜二丁目,25,2,1,1
2016/9/30,141097,港北区,北新横浜二丁目,26,8,3,5
2016/9/30,141097,港北区,北新横浜二丁目,27,6,5,1
2016/9/30,141097,港北区,北新横浜二丁目,28,12,5,7
2016/9/30,141097,港北区,北新横浜二丁目,29,9,2,7
2016/9/30,141097,港北区,北新横浜二丁目,30,13,7,6
2016/9/30,141097,港北区,北新横浜二丁目,31,15,7,8
2016/9/30,141097,港北区,北新横浜二丁目,32,20,10,10
2016/9/30,141097,港北区,北新横浜二丁目,33,20,9,11
2016/9/30,141097,港北区,北新横浜二丁目,34,16,12,4
2016/9/30,141097,港北区,北新横浜二丁目,35,20,6,14
2016/9/30,141097,港北区,北新横浜二丁目,36,21,9,12
2016/9/30,141097,港北区,北新横浜二丁目,37,13,9,4
2016/9/30,141097,港北区,北新横浜二丁目,38,22,11,11
2016/9/30,141097,港北区,北新横浜二丁目,39,25,14,11
2016/9/30,141097,港北区,北新横浜二丁目,40,18,11,7
2016/9/30,141097,港北区,北新横浜二丁目,41,23,13,10
2016/9/30,141097,港北区,北新横浜二丁目,42,13,5,8
2016/9/30,141097,港北区,北新横浜二丁目,43,10,5,5
2016/9/30,141097,港北区,北新横浜二丁目,44,10,7,3
2016/9/30,141097,港北区,北新横浜二丁目,45,11,8,3
2016/9/30,141097,港北区,北新横浜二丁目,46,7,4,3
2016/9/30,141097,港北区,北新横浜二丁目,47,8,7,1
2016/9/30,141097,港北区,北新横浜二丁目,48,4,0,4
2016/9/30,141097,港北区,北新横浜二丁目,49,7,3,4
2016/9/30,141097,港北区,北新横浜二丁目,50,3,2,1
2016/9/30,141097,港北区,北新横浜二丁目,51,11,8,3
2016/9/30,141097,港北区,北新横浜二丁目,52,7,3,4
2016/9/30,141097,港北区,北新横浜二丁目,53,4,2,2
2016/9/30,141097,港北区,北新横浜二丁目,54,8,5,3
2016/9/30,141097,港北区,北新横浜二丁目,55,4,1,3
2016/9/30,141097,港北区,北新横浜二丁目,56,2,1,1
2016/9/30,141097,港北区,北新横浜二丁目,57,4,3,1
2016/9/30,141097,港北区,北新横浜二丁目,58,4,2,2
2016/9/30,141097,港北区,北新横浜二丁目,59,3,2,1
2016/9/30,141097,港北区,北新横浜二丁目,60,0,0,0
2016/9/30,141097,港北区,北新横浜二丁目,61,3,2,1
2016/9/30,141097,港北区,北新横浜二丁目,62,1,0,1
2016/9/30,141097,港北区,北新横浜二丁目,63,0,0,0
2016/9/30,141097,港北区,北新横浜二丁目,64,4,2,2
2016/9/30,141097,港北区,北新横浜二丁目,65,2,1,1
2016/9/30,141097,港北区,北新横浜二丁目,66,6,3,3
2016/9/30,141097,港北区,北新横浜二丁目,67,3,1,2
2016/9/30,141097,港北区,北新横浜二丁目,68,3,0,3
2016/9/30,141097,港北区,北新横浜二丁目,69,1,1,0
2016/9/30,141097,港北区,北新横浜二丁目,70,0,0,0
2016/9/30,141097,港北区,北新横浜二丁目,71,1,1,0
2016/9/30,141097,港北区,北新横浜二丁目,72,2,0,2
2016/9/30,141097,港北区,北新横浜二丁目,73,8,3,5
2016/9/30,141097,港北区,北新横浜二丁目,74,1,1,0
2016/9/30,141097,港北区,北新横浜二丁目,75,3,1,2
2016/9/30,141097,港北区,北新横浜二丁目,76,5,2,3
2016/9/30,141097,港北区,北新横浜二丁目,77,4,3,1
2016/9/30,141097,港北区,北新横浜二丁目,78,7,3,4
2016/9/30,141097,港北区,北新横浜二丁目,79,4,0,4
2016/9/30,141097,港北区,北新横浜二丁目,80,8,3,5
2016/9/30,141097,港北区,北新横浜二丁目,81,6,1,5
2016/9/30,141097,港北区,北新横浜二丁目,82,9,2,7
2016/9/30,141097,港北区,北新横浜二丁目,83,6,1,5
2016/9/30,141097,港北区,北新横浜二丁目,84,7,1,6
2016/9/30,141097,港北区,北新横浜二丁目,85,6,2,4
2016/9/30,141097,港北区,北新横浜二丁目,86,8,1,7
2016/9/30,141097,港北区,北新横浜二丁目,87,8,2,6
2016/9/30,141097,港北区,北新横浜二丁目,88,6,2,4
2016/9/30,141097,港北区,北新横浜二丁目,89,9,2,7
2016/9/30,141097,港北区,北新横浜二丁目,90,8,3,5
2016/9/30,141097,港北区,北新横浜二丁目,91,1,0,1
2016/9/30,141097,港北区,北新横浜二丁目,92,5,0,5
2016/9/30,141097,港北区,北新横浜二丁目,93,5,3,2
2016/9/30,141097,港北区,北新横浜二丁目,94,3,0,3
2016/9/30,141097,港北区,北新横浜二丁目,95,1,1,0
2016/9/30,141097,港北区,北新横浜二丁目,96,1,0,1
2016/9/30,141097,港北区,北新横浜二丁目,97,0,0,0
2016/9/30,141097,港北区,北新横浜二丁目,98,3,1,2
2016/9/30,141097,港北区,北新横浜二丁目,99,0,0,0
2016/9/30,141097,港北区,北新横浜二丁目,100,3,0,3
2016/9/30,141097,港北区,大倉山一丁目,合計,3341,1534,1807
2016/9/30,141097,港北区,大倉山一丁目,0,50,25,25
2016/9/30,141097,港北区,大倉山一丁目,1,64,41,23
2016/9/30,141097,港北区,大倉山一丁目,2,64,36,28
2016/9/30,141097,港北区,大倉山一丁目,3,53,27,26
2016/9/30,141097,港北区,大倉山一丁目,4,52,24,28
2016/9/30,141097,港北区,大倉山一丁目,5,55,23,32
2016/9/30,141097,港北区,大倉山一丁目,6,50,24,26
2016/9/30,141097,港北区,大倉山一丁目,7,33,20,13
2016/9/30,141097,港北区,大倉山一丁目,8,37,22,15
2016/9/30,141097,港北区,大倉山一丁目,9,26,13,13
2016/9/30,141097,港北区,大倉山一丁目,10,22,10,12
2016/9/30,141097,港北区,大倉山一丁目,11,18,8,10
2016/9/30,141097,港北区,大倉山一丁目,12,12,8,4
2016/9/30,141097,港北区,大倉山一丁目,13,14,5,9
2016/9/30,141097,港北区,大倉山一丁目,14,18,12,6
2016/9/30,141097,港北区,大倉山一丁目,15,10,8,2
2016/9/30,141097,港北区,大倉山一丁目,16,17,10,7
2016/9/30,141097,港北区,大倉山一丁目,17,16,5,11
2016/9/30,141097,港北区,大倉山一丁目,18,18,8,10
2016/9/30,141097,港北区,大倉山一丁目,19,14,5,9
2016/9/30,141097,港北区,大倉山一丁目,20,18,10,8
2016/9/30,141097,港北区,大倉山一丁目,21,22,9,13
2016/9/30,141097,港北区,大倉山一丁目,22,21,5,16
2016/9/30,141097,港北区,大倉山一丁目,23,22,10,12
2016/9/30,141097,港北区,大倉山一丁目,24,23,6,17
2016/9/30,141097,港北区,大倉山一丁目,25,34,16,18
2016/9/30,141097,港北区,大倉山一丁目,26,33,14,19
2016/9/30,141097,港北区,大倉山一丁目,27,44,19,25
2016/9/30,141097,港北区,大倉山一丁目,28,53,22,31
2016/9/30,141097,港北区,大倉山一丁目,29,51,21,30
2016/9/30,141097,港北区,大倉山一丁目,30,50,17,33
2016/9/30,141097,港北区,大倉山一丁目,31,64,26,38
2016/9/30,141097,港北区,大倉山一丁目,32,71,29,42
2016/9/30,141097,港北区,大倉山一丁目,33,83,31,52
2016/9/30,141097,港北区,大倉山一丁目,34,80,35,45
2016/9/30,141097,港北区,大倉山一丁目,35,71,29,42
2016/9/30,141097,港北区,大倉山一丁目,36,87,39,48
2016/9/30,141097,港北区,大倉山一丁目,37,87,41,46
2016/9/30,141097,港北区,大倉山一丁目,38,98,56,42
2016/9/30,141097,港北区,大倉山一丁目,39,77,42,35
2016/9/30,141097,港北区,大倉山一丁目,40,77,35,42
2016/9/30,141097,港北区,大倉山一丁目,41,70,31,39
2016/9/30,141097,港北区,大倉山一丁目,42,72,40,32
2016/9/30,141097,港北区,大倉山一丁目,43,74,41,33
2016/9/30,141097,港北区,大倉山一丁目,44,76,31,45
2016/9/30,141097,港北区,大倉山一丁目,45,61,28,33
2016/9/30,141097,港北区,大倉山一丁目,46,54,20,34
2016/9/30,141097,港北区,大倉山一丁目,47,73,41,32
2016/9/30,141097,港北区,大倉山一丁目,48,58,28,30
2016/9/30,141097,港北区,大倉山一丁目,49,50,24,26
2016/9/30,141097,港北区,大倉山一丁目,50,38,18,20
2016/9/30,141097,港北区,大倉山一丁目,51,58,31,27
2016/9/30,141097,港北区,大倉山一丁目,52,24,7,17
2016/9/30,141097,港北区,大倉山一丁目,53,40,20,20
2016/9/30,141097,港北区,大倉山一丁目,54,29,15,14
2016/9/30,141097,港北区,大倉山一丁目,55,33,16,17
2016/9/30,141097,港北区,大倉山一丁目,56,32,12,20
2016/9/30,141097,港北区,大倉山一丁目,57,31,16,15
2016/9/30,141097,港北区,大倉山一丁目,58,22,10,12
2016/9/30,141097,港北区,大倉山一丁目,59,28,12,16
2016/9/30,141097,港北区,大倉山一丁目,60,24,11,13
2016/9/30,141097,港北区,大倉山一丁目,61,16,6,10
2016/9/30,141097,港北区,大倉山一丁目,62,29,13,16
2016/9/30,141097,港北区,大倉山一丁目,63,24,13,11
2016/9/30,141097,港北区,大倉山一丁目,64,37,17,20
2016/9/30,141097,港北区,大倉山一丁目,65,16,9,7
2016/9/30,141097,港北区,大倉山一丁目,66,36,18,18
2016/9/30,141097,港北区,大倉山一丁目,67,32,14,18
2016/9/30,141097,港北区,大倉山一丁目,68,32,10,22
2016/9/30,141097,港北区,大倉山一丁目,69,38,15,23
2016/9/30,141097,港北区,大倉山一丁目,70,15,5,10
2016/9/30,141097,港北区,大倉山一丁目,71,22,6,16
2016/9/30,141097,港北区,大倉山一丁目,72,20,10,10
2016/9/30,141097,港北区,大倉山一丁目,73,18,9,9
2016/9/30,141097,港北区,大倉山一丁目,74,21,7,14
2016/9/30,141097,港北区,大倉山一丁目,75,24,8,16
2016/9/30,141097,港北区,大倉山一丁目,76,12,7,5
2016/9/30,141097,港北区,大倉山一丁目,77,23,7,16
2016/9/30,141097,港北区,大倉山一丁目,78,20,10,10
2016/9/30,141097,港北区,大倉山一丁目,79,6,3,3
2016/9/30,141097,港北区,大倉山一丁目,80,22,10,12
2016/9/30,141097,港北区,大倉山一丁目,81,18,12,6
2016/9/30,141097,港北区,大倉山一丁目,82,15,3,12
2016/9/30,141097,港北区,大倉山一丁目,83,15,7,8
2016/9/30,141097,港北区,大倉山一丁目,84,11,5,6
2016/9/30,141097,港北区,大倉山一丁目,85,7,1,6
2016/9/30,141097,港北区,大倉山一丁目,86,9,2,7
2016/9/30,141097,港北区,大倉山一丁目,87,6,3,3
2016/9/30,141097,港北区,大倉山一丁目,88,5,2,3
2016/9/30,141097,港北区,大倉山一丁目,89,6,0,6
2016/9/30,141097,港北区,大倉山一丁目,90,12,1,11
2016/9/30,141097,港北区,大倉山一丁目,91,2,1,1
2016/9/30,141097,港北区,大倉山一丁目,92,5,1,4
2016/9/30,141097,港北区,大倉山一丁目,93,3,1,2
2016/9/30,141097,港北区,大倉山一丁目,94,2,0,2
2016/9/30,141097,港北区,大倉山一丁目,95,0,0,0
2016/9/30,141097,港北区,大倉山一丁目,96,3,0,3
2016/9/30,141097,港北区,大倉山一丁目,97,0,0,0
2016/9/30,141097,港北区,大倉山一丁目,98,0,0,0
2016/9/30,141097,港北区,大倉山一丁目,99,0,0,0
2016/9/30,141097,港北区,大倉山一丁目,100,3,0,3
2016/9/30,141097,港北区,大倉山二丁目,合計,1856,902,954
2016/9/30,141097,港北区,大倉山二丁目,0,16,8,8
2016/9/30,141097,港北区,大倉山二丁目,1,20,10,10
2016/9/30,141097,港北区,大倉山二丁目,2,15,6,9
2016/9/30,141097,港北区,大倉山二丁目,3,12,4,8
2016/9/30,141097,港北区,大倉山二丁目,4,10,7,3
2016/9/30,141097,港北区,大倉山二丁目,5,14,9,5
2016/9/30,141097,港北区,大倉山二丁目,6,11,6,5
2016/9/30,141097,港北区,大倉山二丁目,7,12,3,9
2016/9/30,141097,港北区,大倉山二丁目,8,15,5,10
2016/9/30,141097,港北区,大倉山二丁目,9,17,10,7
2016/9/30,141097,港北区,大倉山二丁目,10,15,5,10
2016/9/30,141097,港北区,大倉山二丁目,11,11,7,4
2016/9/30,141097,港北区,大倉山二丁目,12,24,10,14
2016/9/30,141097,港北区,大倉山二丁目,13,16,6,10
2016/9/30,141097,港北区,大倉山二丁目,14,17,4,13
2016/9/30,141097,港北区,大倉山二丁目,15,20,6,14
2016/9/30,141097,港北区,大倉山二丁目,16,14,10,4
2016/9/30,141097,港北区,大倉山二丁目,17,18,11,7
2016/9/30,141097,港北区,大倉山二丁目,18,16,9,7
2016/9/30,141097,港北区,大倉山二丁目,19,15,7,8
2016/9/30,141097,港北区,大倉山二丁目,20,18,8,10
2016/9/30,141097,港北区,大倉山二丁目,21,15,6,9
2016/9/30,141097,港北区,大倉山二丁目,22,18,5,13
2016/9/30,141097,港北区,大倉山二丁目,23,21,16,5
2016/9/30,141097,港北区,大倉山二丁目,24,16,7,9
2016/9/30,141097,港北区,大倉山二丁目,25,17,8,9
2016/9/30,141097,港北区,大倉山二丁目,26,26,9,17
2016/9/30,141097,港北区,大倉山二丁目,27,28,11,17
2016/9/30,141097,港北区,大倉山二丁目,28,33,15,18
2016/9/30,141097,港北区,大倉山二丁目,29,36,14,22
2016/9/30,141097,港北区,大倉山二丁目,30,31,16,15
2016/9/30,141097,港北区,大倉山二丁目,31,25,13,12
2016/9/30,141097,港北区,大倉山二丁目,32,30,15,15
2016/9/30,141097,港北区,大倉山二丁目,33,28,14,14
2016/9/30,141097,港北区,大倉山二丁目,34,32,19,13
2016/9/30,141097,港北区,大倉山二丁目,35,26,11,15
2016/9/30,141097,港北区,大倉山二丁目,36,27,15,12
2016/9/30,141097,港北区,大倉山二丁目,37,28,10,18
2016/9/30,141097,港北区,大倉山二丁目,38,29,17,12
2016/9/30,141097,港北区,大倉山二丁目,39,28,16,12
2016/9/30,141097,港北区,大倉山二丁目,40,27,12,15
2016/9/30,141097,港北区,大倉山二丁目,41,36,14,22
2016/9/30,141097,港北区,大倉山二丁目,42,38,23,15
2016/9/30,141097,港北区,大倉山二丁目,43,33,16,17
2016/9/30,141097,港北区,大倉山二丁目,44,30,16,14
2016/9/30,141097,港北区,大倉山二丁目,45,34,20,14
2016/9/30,141097,港北区,大倉山二丁目,46,39,23,16
2016/9/30,141097,港北区,大倉山二丁目,47,37,21,16
2016/9/30,141097,港北区,大倉山二丁目,48,28,13,15
2016/9/30,141097,港北区,大倉山二丁目,49,25,13,12
2016/9/30,141097,港北区,大倉山二丁目,50,23,11,12
2016/9/30,141097,港北区,大倉山二丁目,51,29,17,12
2016/9/30,141097,港北区,大倉山二丁目,52,18,9,9
2016/9/30,141097,港北区,大倉山二丁目,53,28,15,13
2016/9/30,141097,港北区,大倉山二丁目,54,26,13,13
2016/9/30,141097,港北区,大倉山二丁目,55,16,9,7
2016/9/30,141097,港北区,大倉山二丁目,56,26,12,14
2016/9/30,141097,港北区,大倉山二丁目,57,23,16,7
2016/9/30,141097,港北区,大倉山二丁目,58,27,13,14
2016/9/30,141097,港北区,大倉山二丁目,59,20,9,11
2016/9/30,141097,港北区,大倉山二丁目,60,17,10,7
2016/9/30,141097,港北区,大倉山二丁目,61,12,8,4
2016/9/30,141097,港北区,大倉山二丁目,62,14,6,8
2016/9/30,141097,港北区,大倉山二丁目,63,23,11,12
2016/9/30,141097,港北区,大倉山二丁目,64,11,7,4
2016/9/30,141097,港北区,大倉山二丁目,65,19,10,9
2016/9/30,141097,港北区,大倉山二丁目,66,20,11,9
2016/9/30,141097,港北区,大倉山二丁目,67,21,8,13
2016/9/30,141097,港北区,大倉山二丁目,68,22,12,10
2016/9/30,141097,港北区,大倉山二丁目,69,31,17,14
2016/9/30,141097,港北区,大倉山二丁目,70,16,7,9
2016/9/30,141097,港北区,大倉山二丁目,71,19,10,9
2016/9/30,141097,港北区,大倉山二丁目,72,17,9,8
2016/9/30,141097,港北区,大倉山二丁目,73,19,6,13
2016/9/30,141097,港北区,大倉山二丁目,74,13,7,6
2016/9/30,141097,港北区,大倉山二丁目,75,15,8,7
2016/9/30,141097,港北区,大倉山二丁目,76,12,7,5
2016/9/30,141097,港北区,大倉山二丁目,77,13,9,4
2016/9/30,141097,港北区,大倉山二丁目,78,12,5,7
2016/9/30,141097,港北区,大倉山二丁目,79,10,4,6
2016/9/30,141097,港北区,大倉山二丁目,80,13,3,10
2016/9/30,141097,港北区,大倉山二丁目,81,15,3,12
2016/9/30,141097,港北区,大倉山二丁目,82,17,3,14
2016/9/30,141097,港北区,大倉山二丁目,83,13,4,9
2016/9/30,141097,港北区,大倉山二丁目,84,15,7,8
2016/9/30,141097,港北区,大倉山二丁目,85,7,5,2
2016/9/30,141097,港北区,大倉山二丁目,86,8,2,6
2016/9/30,141097,港北区,大倉山二丁目,87,4,2,2
2016/9/30,141097,港北区,大倉山二丁目,88,7,3,4
2016/9/30,141097,港北区,大倉山二丁目,89,10,3,7
2016/9/30,141097,港北区,大倉山二丁目,90,9,6,3
2016/9/30,141097,港北区,大倉山二丁目,91,7,2,5
2016/9/30,141097,港北区,大倉山二丁目,92,4,0,4
2016/9/30,141097,港北区,大倉山二丁目,93,1,1,0
2016/9/30,141097,港北区,大倉山二丁目,94,2,1,1
2016/9/30,141097,港北区,大倉山二丁目,95,3,1,2
2016/9/30,141097,港北区,大倉山二丁目,96,1,0,1
2016/9/30,141097,港北区,大倉山二丁目,97,0,0,0
2016/9/30,141097,港北区,大倉山二丁目,98,0,0,0
2016/9/30,141097,港北区,大倉山二丁目,99,1,1,0
2016/9/30,141097,港北区,大倉山二丁目,100,0,0,0
2016/9/30,141097,港北区,大倉山三丁目,合計,4068,1915,2153
2016/9/30,141097,港北区,大倉山三丁目,0,36,20,16
2016/9/30,141097,港北区,大倉山三丁目,1,38,21,17
2016/9/30,141097,港北区,大倉山三丁目,2,37,22,15
2016/9/30,141097,港北区,大倉山三丁目,3,25,11,14
2016/9/30,141097,港北区,大倉山三丁目,4,37,20,17
2016/9/30,141097,港北区,大倉山三丁目,5,40,24,16
2016/9/30,141097,港北区,大倉山三丁目,6,32,14,18
2016/9/30,141097,港北区,大倉山三丁目,7,32,17,15
2016/9/30,141097,港北区,大倉山三丁目,8,33,15,18
2016/9/30,141097,港北区,大倉山三丁目,9,29,13,16
2016/9/30,141097,港北区,大倉山三丁目,10,23,8,15
2016/9/30,141097,港北区,大倉山三丁目,11,26,12,14
2016/9/30,141097,港北区,大倉山三丁目,12,31,15,16
2016/9/30,141097,港北区,大倉山三丁目,13,43,18,25
2016/9/30,141097,港北区,大倉山三丁目,14,34,21,13
2016/9/30,141097,港北区,大倉山三丁目,15,25,11,14
2016/9/30,141097,港北区,大倉山三丁目,16,39,18,21
2016/9/30,141097,港北区,大倉山三丁目,17,34,16,18
2016/9/30,141097,港北区,大倉山三丁目,18,33,18,15
2016/9/30,141097,港北区,大倉山三丁目,19,42,25,17
2016/9/30,141097,港北区,大倉山三丁目,20,47,26,21
2016/9/30,141097,港北区,大倉山三丁目,21,40,18,22
2016/9/30,141097,港北区,大倉山三丁目,22,32,18,14
2016/9/30,141097,港北区,大倉山三丁目,23,35,17,18
2016/9/30,141097,港北区,大倉山三丁目,24,43,16,27
2016/9/30,141097,港北区,大倉山三丁目,25,48,21,27
2016/9/30,141097,港北区,大倉山三丁目,26,52,20,32
2016/9/30,141097,港北区,大倉山三丁目,27,45,18,27
2016/9/30,141097,港北区,大倉山三丁目,28,44,21,23
2016/9/30,141097,港北区,大倉山三丁目,29,63,25,38
2016/9/30,141097,港北区,大倉山三丁目,30,49,20,29
2016/9/30,141097,港北区,大倉山三丁目,31,74,34,40
2016/9/30,141097,港北区,大倉山三丁目,32,56,26,30
2016/9/30,141097,港北区,大倉山三丁目,33,61,24,37
2016/9/30,141097,港北区,大倉山三丁目,34,58,29,29
2016/9/30,141097,港北区,大倉山三丁目,35,65,37,28
2016/9/30,141097,港北区,大倉山三丁目,36,67,32,35
2016/9/30,141097,港北区,大倉山三丁目,37,62,25,37
2016/9/30,141097,港北区,大倉山三丁目,38,52,25,27
2016/9/30,141097,港北区,大倉山三丁目,39,69,38,31
2016/9/30,141097,港北区,大倉山三丁目,40,76,34,42
2016/9/30,141097,港北区,大倉山三丁目,41,66,30,36
2016/9/30,141097,港北区,大倉山三丁目,42,77,30,47
2016/9/30,141097,港北区,大倉山三丁目,43,87,34,53
2016/9/30,141097,港北区,大倉山三丁目,44,64,23,41
2016/9/30,141097,港北区,大倉山三丁目,45,87,43,44
2016/9/30,141097,港北区,大倉山三丁目,46,68,36,32
2016/9/30,141097,港北区,大倉山三丁目,47,89,51,38
2016/9/30,141097,港北区,大倉山三丁目,48,68,30,38
2016/9/30,141097,港北区,大倉山三丁目,49,79,42,37
2016/9/30,141097,港北区,大倉山三丁目,50,69,33,36
2016/9/30,141097,港北区,大倉山三丁目,51,76,38,38
2016/9/30,141097,港北区,大倉山三丁目,52,54,31,23
2016/9/30,141097,港北区,大倉山三丁目,53,78,33,45
2016/9/30,141097,港北区,大倉山三丁目,54,62,33,29
2016/9/30,141097,港北区,大倉山三丁目,55,39,15,24
2016/9/30,141097,港北区,大倉山三丁目,56,53,30,23
2016/9/30,141097,港北区,大倉山三丁目,57,45,21,24
2016/9/30,141097,港北区,大倉山三丁目,58,59,33,26
2016/9/30,141097,港北区,大倉山三丁目,59,38,22,16
2016/9/30,141097,港北区,大倉山三丁目,60,47,24,23
2016/9/30,141097,港北区,大倉山三丁目,61,37,18,19
2016/9/30,141097,港北区,大倉山三丁目,62,41,19,22
2016/9/30,141097,港北区,大倉山三丁目,63,35,18,17
2016/9/30,141097,港北区,大倉山三丁目,64,43,23,20
2016/9/30,141097,港北区,大倉山三丁目,65,40,16,24
2016/9/30,141097,港北区,大倉山三丁目,66,47,29,18
2016/9/30,141097,港北区,大倉山三丁目,67,47,21,26
2016/9/30,141097,港北区,大倉山三丁目,68,37,18,19
2016/9/30,141097,港北区,大倉山三丁目,69,34,20,14
2016/9/30,141097,港北区,大倉山三丁目,70,36,18,18
2016/9/30,141097,港北区,大倉山三丁目,71,33,11,22
2016/9/30,141097,港北区,大倉山三丁目,72,34,13,21
2016/9/30,141097,港北区,大倉山三丁目,73,29,16,13
2016/9/30,141097,港北区,大倉山三丁目,74,36,19,17
2016/9/30,141097,港北区,大倉山三丁目,75,31,14,17
2016/9/30,141097,港北区,大倉山三丁目,76,34,14,20
2016/9/30,141097,港北区,大倉山三丁目,77,25,8,17
2016/9/30,141097,港北区,大倉山三丁目,78,26,11,15
2016/9/30,141097,港北区,大倉山三丁目,79,27,11,16
2016/9/30,141097,港北区,大倉山三丁目,80,36,19,17
2016/9/30,141097,港北区,大倉山三丁目,81,25,11,14
2016/9/30,141097,港北区,大倉山三丁目,82,21,7,14
2016/9/30,141097,港北区,大倉山三丁目,83,31,9,22
2016/9/30,141097,港北区,大倉山三丁目,84,17,8,9
2016/9/30,141097,港北区,大倉山三丁目,85,21,5,16
2016/9/30,141097,港北区,大倉山三丁目,86,21,7,14
2016/9/30,141097,港北区,大倉山三丁目,87,15,8,7
2016/9/30,141097,港北区,大倉山三丁目,88,17,4,13
2016/9/30,141097,港北区,大倉山三丁目,89,13,5,8
2016/9/30,141097,港北区,大倉山三丁目,90,20,4,16
2016/9/30,141097,港北区,大倉山三丁目,91,10,4,6
2016/9/30,141097,港北区,大倉山三丁目,92,9,3,6
2016/9/30,141097,港北区,大倉山三丁目,93,5,2,3
2016/9/30,141097,港北区,大倉山三丁目,94,8,2,6
2016/9/30,141097,港北区,大倉山三丁目,95,4,2,2
2016/9/30,141097,港北区,大倉山三丁目,96,1,0,1
2016/9/30,141097,港北区,大倉山三丁目,97,4,1,3
2016/9/30,141097,港北区,大倉山三丁目,98,2,0,2
2016/9/30,141097,港北区,大倉山三丁目,99,3,2,1
2016/9/30,141097,港北区,大倉山三丁目,100,1,0,1
2016/9/30,141097,港北区,大倉山四丁目,合計,4516,2197,2319
2016/9/30,141097,港北区,大倉山四丁目,0,49,20,29
2016/9/30,141097,港北区,大倉山四丁目,1,68,36,32
2016/9/30,141097,港北区,大倉山四丁目,2,56,28,28
2016/9/30,141097,港北区,大倉山四丁目,3,51,26,25
2016/9/30,141097,港北区,大倉山四丁目,4,59,29,30
2016/9/30,141097,港北区,大倉山四丁目,5,42,21,21
2016/9/30,141097,港北区,大倉山四丁目,6,46,21,25
2016/9/30,141097,港北区,大倉山四丁目,7,43,22,21
2016/9/30,141097,港北区,大倉山四丁目,8,36,17,19
2016/9/30,141097,港北区,大倉山四丁目,9,42,24,18
2016/9/30,141097,港北区,大倉山四丁目,10,37,23,14
2016/9/30,141097,港北区,大倉山四丁目,11,46,26,20
2016/9/30,141097,港北区,大倉山四丁目,12,30,16,14
2016/9/30,141097,港北区,大倉山四丁目,13,41,19,22
2016/9/30,141097,港北区,大倉山四丁目,14,42,20,22
2016/9/30,141097,港北区,大倉山四丁目,15,35,17,18
2016/9/30,141097,港北区,大倉山四丁目,16,39,16,23
2016/9/30,141097,港北区,大倉山四丁目,17,37,21,16
2016/9/30,141097,港北区,大倉山四丁目,18,41,16,25
2016/9/30,141097,港北区,大倉山四丁目,19,28,16,12
2016/9/30,141097,港北区,大倉山四丁目,20,40,16,24
2016/9/30,141097,港北区,大倉山四丁目,21,29,19,10
2016/9/30,141097,港北区,大倉山四丁目,22,33,13,20
2016/9/30,141097,港北区,大倉山四丁目,23,30,17,13
2016/9/30,141097,港北区,大倉山四丁目,24,28,14,14
2016/9/30,141097,港北区,大倉山四丁目,25,43,17,26
2016/9/30,141097,港北区,大倉山四丁目,26,36,19,17
2016/9/30,141097,港北区,大倉山四丁目,27,51,24,27
2016/9/30,141097,港北区,大倉山四丁目,28,57,31,26
2016/9/30,141097,港北区,大倉山四丁目,29,60,32,28
2016/9/30,141097,港北区,大倉山四丁目,30,69,37,32
2016/9/30,141097,港北区,大倉山四丁目,31,67,37,30
2016/9/30,141097,港北区,大倉山四丁目,32,66,28,38
2016/9/30,141097,港北区,大倉山四丁目,33,69,32,37
2016/9/30,141097,港北区,大倉山四丁目,34,83,38,45
2016/9/30,141097,港北区,大倉山四丁目,35,83,43,40
2016/9/30,141097,港北区,大倉山四丁目,36,98,48,50
2016/9/30,141097,港北区,大倉山四丁目,37,94,45,49
2016/9/30,141097,港北区,大倉山四丁目,38,91,47,44
2016/9/30,141097,港北区,大倉山四丁目,39,77,40,37
2016/9/30,141097,港北区,大倉山四丁目,40,80,33,47
2016/9/30,141097,港北区,大倉山四丁目,41,68,35,33
2016/9/30,141097,港北区,大倉山四丁目,42,86,43,43
2016/9/30,141097,港北区,大倉山四丁目,43,81,45,36
2016/9/30,141097,港北区,大倉山四丁目,44,73,35,38
2016/9/30,141097,港北区,大倉山四丁目,45,73,30,43
2016/9/30,141097,港北区,大倉山四丁目,46,77,46,31
2016/9/30,141097,港北区,大倉山四丁目,47,87,44,43
2016/9/30,141097,港北区,大倉山四丁目,48,89,43,46
2016/9/30,141097,港北区,大倉山四丁目,49,82,44,38
2016/9/30,141097,港北区,大倉山四丁目,50,50,24,26
2016/9/30,141097,港北区,大倉山四丁目,51,66,28,38
2016/9/30,141097,港北区,大倉山四丁目,52,65,30,35
2016/9/30,141097,港北区,大倉山四丁目,53,51,29,22
2016/9/30,141097,港北区,大倉山四丁目,54,55,24,31
2016/9/30,141097,港北区,大倉山四丁目,55,55,25,30
2016/9/30,141097,港北区,大倉山四丁目,56,43,22,21
2016/9/30,141097,港北区,大倉山四丁目,57,58,30,28
2016/9/30,141097,港北区,大倉山四丁目,58,55,30,25
2016/9/30,141097,港北区,大倉山四丁目,59,37,22,15
2016/9/30,141097,港北区,大倉山四丁目,60,42,27,15
2016/9/30,141097,港北区,大倉山四丁目,61,45,25,20
2016/9/30,141097,港北区,大倉山四丁目,62,44,13,31
2016/9/30,141097,港北区,大倉山四丁目,63,44,23,21
2016/9/30,141097,港北区,大倉山四丁目,64,52,28,24
2016/9/30,141097,港北区,大倉山四丁目,65,51,20,31
2016/9/30,141097,港北区,大倉山四丁目,66,62,34,28
2016/9/30,141097,港北区,大倉山四丁目,67,53,26,27
2016/9/30,141097,港北区,大倉山四丁目,68,47,24,23
2016/9/30,141097,港北区,大倉山四丁目,69,59,28,31
2016/9/30,141097,港北区,大倉山四丁目,70,29,12,17
2016/9/30,141097,港北区,大倉山四丁目,71,24,9,15
2016/9/30,141097,港北区,大倉山四丁目,72,35,16,19
2016/9/30,141097,港北区,大倉山四丁目,73,43,16,27
2016/9/30,141097,港北区,大倉山四丁目,74,50,16,34
2016/9/30,141097,港北区,大倉山四丁目,75,33,18,15
2016/9/30,141097,港北区,大倉山四丁目,76,29,15,14
2016/9/30,141097,港北区,大倉山四丁目,77,39,23,16
2016/9/30,141097,港北区,大倉山四丁目,78,25,9,16
2016/9/30,141097,港北区,大倉山四丁目,79,39,15,24
2016/9/30,141097,港北区,大倉山四丁目,80,34,15,19
2016/9/30,141097,港北区,大倉山四丁目,81,20,7,13
2016/9/30,141097,港北区,大倉山四丁目,82,25,14,11
2016/9/30,141097,港北区,大倉山四丁目,83,29,13,16
2016/9/30,141097,港北区,大倉山四丁目,84,20,6,14
2016/9/30,141097,港北区,大倉山四丁目,85,26,8,18
2016/9/30,141097,港北区,大倉山四丁目,86,16,4,12
2016/9/30,141097,港北区,大倉山四丁目,87,22,9,13
2016/9/30,141097,港北区,大倉山四丁目,88,14,4,10
2016/9/30,141097,港北区,大倉山四丁目,89,12,8,4
2016/9/30,141097,港北区,大倉山四丁目,90,15,6,9
2016/9/30,141097,港北区,大倉山四丁目,91,8,2,6
2016/9/30,141097,港北区,大倉山四丁目,92,11,5,6
2016/9/30,141097,港北区,大倉山四丁目,93,3,1,2
2016/9/30,141097,港北区,大倉山四丁目,94,3,1,2
2016/9/30,141097,港北区,大倉山四丁目,95,2,0,2
2016/9/30,141097,港北区,大倉山四丁目,96,3,1,2
2016/9/30,141097,港北区,大倉山四丁目,97,2,1,1
2016/9/30,141097,港北区,大倉山四丁目,98,1,0,1
2016/9/30,141097,港北区,大倉山四丁目,99,0,0,0
2016/9/30,141097,港北区,大倉山四丁目,100,2,2,0
2016/9/30,141097,港北区,大倉山五丁目,合計,5503,2658,2845
2016/9/30,141097,港北区,大倉山五丁目,0,48,21,27
2016/9/30,141097,港北区,大倉山五丁目,1,37,18,19
2016/9/30,141097,港北区,大倉山五丁目,2,62,27,35
2016/9/30,141097,港北区,大倉山五丁目,3,55,24,31
2016/9/30,141097,港北区,大倉山五丁目,4,48,29,19
2016/9/30,141097,港北区,大倉山五丁目,5,54,29,25
2016/9/30,141097,港北区,大倉山五丁目,6,57,25,32
2016/9/30,141097,港北区,大倉山五丁目,7,53,28,25
2016/9/30,141097,港北区,大倉山五丁目,8,66,33,33
2016/9/30,141097,港北区,大倉山五丁目,9,58,24,34
2016/9/30,141097,港北区,大倉山五丁目,10,51,30,21
2016/9/30,141097,港北区,大倉山五丁目,11,56,29,27
2016/9/30,141097,港北区,大倉山五丁目,12,60,33,27
2016/9/30,141097,港北区,大倉山五丁目,13,68,22,46
2016/9/30,141097,港北区,大倉山五丁目,14,69,39,30
2016/9/30,141097,港北区,大倉山五丁目,15,60,29,31
2016/9/30,141097,港北区,大倉山五丁目,16,46,26,20
2016/9/30,141097,港北区,大倉山五丁目,17,55,24,31
2016/9/30,141097,港北区,大倉山五丁目,18,52,27,25
2016/9/30,141097,港北区,大倉山五丁目,19,45,22,23
2016/9/30,141097,港北区,大倉山五丁目,20,45,28,17
2016/9/30,141097,港北区,大倉山五丁目,21,50,25,25
2016/9/30,141097,港北区,大倉山五丁目,22,44,19,25
2016/9/30,141097,港北区,大倉山五丁目,23,45,23,22
2016/9/30,141097,港北区,大倉山五丁目,24,58,23,35
2016/9/30,141097,港北区,大倉山五丁目,25,38,20,18
2016/9/30,141097,港北区,大倉山五丁目,26,46,20,26
2016/9/30,141097,港北区,大倉山五丁目,27,47,26,21
2016/9/30,141097,港北区,大倉山五丁目,28,47,19,28
2016/9/30,141097,港北区,大倉山五丁目,29,59,35,24
2016/9/30,141097,港北区,大倉山五丁目,30,47,20,27
2016/9/30,141097,港北区,大倉山五丁目,31,58,22,36
2016/9/30,141097,港北区,大倉山五丁目,32,63,39,24
2016/9/30,141097,港北区,大倉山五丁目,33,64,36,28
2016/9/30,141097,港北区,大倉山五丁目,34,43,20,23
2016/9/30,141097,港北区,大倉山五丁目,35,69,34,35
2016/9/30,141097,港北区,大倉山五丁目,36,81,44,37
2016/9/30,141097,港北区,大倉山五丁目,37,70,31,39
2016/9/30,141097,港北区,大倉山五丁目,38,90,40,50
2016/9/30,141097,港北区,大倉山五丁目,39,86,38,48
2016/9/30,141097,港北区,大倉山五丁目,40,80,45,35
2016/9/30,141097,港北区,大倉山五丁目,41,110,48,62
2016/9/30,141097,港北区,大倉山五丁目,42,122,51,71
2016/9/30,141097,港北区,大倉山五丁目,43,116,53,63
2016/9/30,141097,港北区,大倉山五丁目,44,118,53,65
2016/9/30,141097,港北区,大倉山五丁目,45,113,59,54
2016/9/30,141097,港北区,大倉山五丁目,46,109,51,58
2016/9/30,141097,港北区,大倉山五丁目,47,101,51,50
2016/9/30,141097,港北区,大倉山五丁目,48,97,54,43
2016/9/30,141097,港北区,大倉山五丁目,49,139,66,73
2016/9/30,141097,港北区,大倉山五丁目,50,93,46,47
2016/9/30,141097,港北区,大倉山五丁目,51,110,57,53
2016/9/30,141097,港北区,大倉山五丁目,52,107,61,46
2016/9/30,141097,港北区,大倉山五丁目,53,79,46,33
2016/9/30,141097,港北区,大倉山五丁目,54,89,45,44
2016/9/30,141097,港北区,大倉山五丁目,55,54,25,29
2016/9/30,141097,港北区,大倉山五丁目,56,64,33,31
2016/9/30,141097,港北区,大倉山五丁目,57,78,44,34
2016/9/30,141097,港北区,大倉山五丁目,58,74,34,40
2016/9/30,141097,港北区,大倉山五丁目,59,51,32,19
2016/9/30,141097,港北区,大倉山五丁目,60,64,29,35
2016/9/30,141097,港北区,大倉山五丁目,61,63,27,36
2016/9/30,141097,港北区,大倉山五丁目,62,64,29,35
2016/9/30,141097,港北区,大倉山五丁目,63,62,29,33
2016/9/30,141097,港北区,大倉山五丁目,64,66,32,34
2016/9/30,141097,港北区,大倉山五丁目,65,65,42,23
2016/9/30,141097,港北区,大倉山五丁目,66,77,34,43
2016/9/30,141097,港北区,大倉山五丁目,67,76,43,33
2016/9/30,141097,港北区,大倉山五丁目,68,68,33,35
2016/9/30,141097,港北区,大倉山五丁目,69,66,32,34
2016/9/30,141097,港北区,大倉山五丁目,70,40,17,23
2016/9/30,141097,港北区,大倉山五丁目,71,49,27,22
2016/9/30,141097,港北区,大倉山五丁目,72,38,15,23
2016/9/30,141097,港北区,大倉山五丁目,73,53,15,38
2016/9/30,141097,港北区,大倉山五丁目,74,48,23,25
2016/9/30,141097,港北区,大倉山五丁目,75,44,22,22
2016/9/30,141097,港北区,大倉山五丁目,76,46,19,27
2016/9/30,141097,港北区,大倉山五丁目,77,23,6,17
2016/9/30,141097,港北区,大倉山五丁目,78,25,8,17
2016/9/30,141097,港北区,大倉山五丁目,79,37,19,18
2016/9/30,141097,港北区,大倉山五丁目,80,42,18,24
2016/9/30,141097,港北区,大倉山五丁目,81,35,19,16
2016/9/30,141097,港北区,大倉山五丁目,82,25,8,17
2016/9/30,141097,港北区,大倉山五丁目,83,36,12,24
2016/9/30,141097,港北区,大倉山五丁目,84,19,10,9
2016/9/30,141097,港北区,大倉山五丁目,85,26,9,17
2016/9/30,141097,港北区,大倉山五丁目,86,15,6,9
2016/9/30,141097,港北区,大倉山五丁目,87,18,6,12
2016/9/30,141097,港北区,大倉山五丁目,88,14,4,10
2016/9/30,141097,港北区,大倉山五丁目,89,11,2,9
2016/9/30,141097,港北区,大倉山五丁目,90,3,1,2
2016/9/30,141097,港北区,大倉山五丁目,91,12,4,8
2016/9/30,141097,港北区,大倉山五丁目,92,5,1,4
2016/9/30,141097,港北区,大倉山五丁目,93,3,0,3
2016/9/30,141097,港北区,大倉山五丁目,94,3,1,2
2016/9/30,141097,港北区,大倉山五丁目,95,2,0,2
2016/9/30,141097,港北区,大倉山五丁目,96,1,0,1
2016/9/30,141097,港北区,大倉山五丁目,97,1,0,1
2016/9/30,141097,港北区,大倉山五丁目,98,0,0,0
2016/9/30,141097,港北区,大倉山五丁目,99,1,0,1
2016/9/30,141097,港北区,大倉山五丁目,100,3,1,2
2016/9/30,141097,港北区,大倉山六丁目,合計,3014,1549,1465
2016/9/30,141097,港北区,大倉山六丁目,0,22,10,12
2016/9/30,141097,港北区,大倉山六丁目,1,21,11,10
2016/9/30,141097,港北区,大倉山六丁目,2,17,9,8
2016/9/30,141097,港北区,大倉山六丁目,3,28,12,16
2016/9/30,141097,港北区,大倉山六丁目,4,14,8,6
2016/9/30,141097,港北区,大倉山六丁目,5,26,16,10
2016/9/30,141097,港北区,大倉山六丁目,6,20,11,9
2016/9/30,141097,港北区,大倉山六丁目,7,27,13,14
2016/9/30,141097,港北区,大倉山六丁目,8,31,15,16
2016/9/30,141097,港北区,大倉山六丁目,9,25,13,12
2016/9/30,141097,港北区,大倉山六丁目,10,21,8,13
2016/9/30,141097,港北区,大倉山六丁目,11,24,13,11
2016/9/30,141097,港北区,大倉山六丁目,12,33,19,14
2016/9/30,141097,港北区,大倉山六丁目,13,28,15,13
2016/9/30,141097,港北区,大倉山六丁目,14,27,13,14
2016/9/30,141097,港北区,大倉山六丁目,15,33,19,14
2016/9/30,141097,港北区,大倉山六丁目,16,34,19,15
2016/9/30,141097,港北区,大倉山六丁目,17,37,20,17
2016/9/30,141097,港北区,大倉山六丁目,18,23,12,11
2016/9/30,141097,港北区,大倉山六丁目,19,30,15,15
2016/9/30,141097,港北区,大倉山六丁目,20,33,16,17
2016/9/30,141097,港北区,大倉山六丁目,21,32,14,18
2016/9/30,141097,港北区,大倉山六丁目,22,34,17,17
2016/9/30,141097,港北区,大倉山六丁目,23,32,14,18
2016/9/30,141097,港北区,大倉山六丁目,24,31,16,15
2016/9/30,141097,港北区,大倉山六丁目,25,27,11,16
2016/9/30,141097,港北区,大倉山六丁目,26,41,20,21
2016/9/30,141097,港北区,大倉山六丁目,27,35,19,16
2016/9/30,141097,港北区,大倉山六丁目,28,34,20,14
2016/9/30,141097,港北区,大倉山六丁目,29,40,21,19
2016/9/30,141097,港北区,大倉山六丁目,30,40,26,14
2016/9/30,141097,港北区,大倉山六丁目,31,42,18,24
2016/9/30,141097,港北区,大倉山六丁目,32,46,30,16
2016/9/30,141097,港北区,大倉山六丁目,33,28,17,11
2016/9/30,141097,港北区,大倉山六丁目,34,47,19,28
2016/9/30,141097,港北区,大倉山六丁目,35,43,23,20
2016/9/30,141097,港北区,大倉山六丁目,36,40,19,21
2016/9/30,141097,港北区,大倉山六丁目,37,41,17,24
2016/9/30,141097,港北区,大倉山六丁目,38,46,23,23
2016/9/30,141097,港北区,大倉山六丁目,39,56,33,23
2016/9/30,141097,港北区,大倉山六丁目,40,46,26,20
2016/9/30,141097,港北区,大倉山六丁目,41,46,24,22
2016/9/30,141097,港北区,大倉山六丁目,42,62,36,26
2016/9/30,141097,港北区,大倉山六丁目,43,52,27,25
2016/9/30,141097,港北区,大倉山六丁目,44,48,33,15
2016/9/30,141097,港北区,大倉山六丁目,45,55,27,28
2016/9/30,141097,港北区,大倉山六丁目,46,60,31,29
2016/9/30,141097,港北区,大倉山六丁目,47,46,22,24
2016/9/30,141097,港北区,大倉山六丁目,48,68,37,31
2016/9/30,141097,港北区,大倉山六丁目,49,67,36,31
2016/9/30,141097,港北区,大倉山六丁目,50,47,28,19
2016/9/30,141097,港北区,大倉山六丁目,51,49,25,24
2016/9/30,141097,港北区,大倉山六丁目,52,52,31,21
2016/9/30,141097,港北区,大倉山六丁目,53,51,29,22
2016/9/30,141097,港北区,大倉山六丁目,54,55,27,28
2016/9/30,141097,港北区,大倉山六丁目,55,40,22,18
2016/9/30,141097,港北区,大倉山六丁目,56,37,19,18
2016/9/30,141097,港北区,大倉山六丁目,57,28,15,13
2016/9/30,141097,港北区,大倉山六丁目,58,32,19,13
2016/9/30,141097,港北区,大倉山六丁目,59,33,18,15
2016/9/30,141097,港北区,大倉山六丁目,60,30,12,18
2016/9/30,141097,港北区,大倉山六丁目,61,29,14,15
2016/9/30,141097,港北区,大倉山六丁目,62,33,17,16
2016/9/30,141097,港北区,大倉山六丁目,63,36,20,16
2016/9/30,141097,港北区,大倉山六丁目,64,39,26,13
2016/9/30,141097,港北区,大倉山六丁目,65,27,18,9
2016/9/30,141097,港北区,大倉山六丁目,66,36,13,23
2016/9/30,141097,港北区,大倉山六丁目,67,40,20,20
2016/9/30,141097,港北区,大倉山六丁目,68,30,15,15
2016/9/30,141097,港北区,大倉山六丁目,69,43,21,22
2016/9/30,141097,港北区,大倉山六丁目,70,22,11,11
2016/9/30,141097,港北区,大倉山六丁目,71,20,10,10
2016/9/30,141097,港北区,大倉山六丁目,72,33,13,20
2016/9/30,141097,港北区,大倉山六丁目,73,39,24,15
2016/9/30,141097,港北区,大倉山六丁目,74,37,13,24
2016/9/30,141097,港北区,大倉山六丁目,75,30,10,20
2016/9/30,141097,港北区,大倉山六丁目,76,23,14,9
2016/9/30,141097,港北区,大倉山六丁目,77,18,8,10
2016/9/30,141097,港北区,大倉山六丁目,78,22,9,13
2016/9/30,141097,港北区,大倉山六丁目,79,17,7,10
2016/9/30,141097,港北区,大倉山六丁目,80,34,15,19
2016/9/30,141097,港北区,大倉山六丁目,81,18,6,12
2016/9/30,141097,港北区,大倉山六丁目,82,6,2,4
2016/9/30,141097,港北区,大倉山六丁目,83,18,12,6
2016/9/30,141097,港北区,大倉山六丁目,84,10,5,5
2016/9/30,141097,港北区,大倉山六丁目,85,12,5,7
2016/9/30,141097,港北区,大倉山六丁目,86,5,0,5
2016/9/30,141097,港北区,大倉山六丁目,87,6,4,2
2016/9/30,141097,港北区,大倉山六丁目,88,8,3,5
2016/9/30,141097,港北区,大倉山六丁目,89,7,3,4
2016/9/30,141097,港北区,大倉山六丁目,90,5,1,4
2016/9/30,141097,港北区,大倉山六丁目,91,4,0,4
2016/9/30,141097,港北区,大倉山六丁目,92,4,1,3
2016/9/30,141097,港北区,大倉山六丁目,93,3,0,3
2016/9/30,141097,港北区,大倉山六丁目,94,2,0,2
2016/9/30,141097,港北区,大倉山六丁目,95,2,1,1
2016/9/30,141097,港北区,大倉山六丁目,96,0,0,0
2016/9/30,141097,港北区,大倉山六丁目,97,2,0,2
2016/9/30,141097,港北区,大倉山六丁目,98,0,0,0
2016/9/30,141097,港北区,大倉山六丁目,99,0,0,0
2016/9/30,141097,港北区,大倉山六丁目,100,1,0,1
2016/9/30,141097,港北区,大倉山七丁目,合計,2994,1499,1495
2016/9/30,141097,港北区,大倉山七丁目,0,23,12,11
2016/9/30,141097,港北区,大倉山七丁目,1,28,15,13
2016/9/30,141097,港北区,大倉山七丁目,2,30,14,16
2016/9/30,141097,港北区,大倉山七丁目,3,22,8,14
2016/9/30,141097,港北区,大倉山七丁目,4,26,14,12
2016/9/30,141097,港北区,大倉山七丁目,5,33,24,9
2016/9/30,141097,港北区,大倉山七丁目,6,25,14,11
2016/9/30,141097,港北区,大倉山七丁目,7,37,20,17
2016/9/30,141097,港北区,大倉山七丁目,8,37,22,15
2016/9/30,141097,港北区,大倉山七丁目,9,25,16,9
2016/9/30,141097,港北区,大倉山七丁目,10,29,16,13
2016/9/30,141097,港北区,大倉山七丁目,11,29,13,16
2016/9/30,141097,港北区,大倉山七丁目,12,25,15,10
2016/9/30,141097,港北区,大倉山七丁目,13,36,15,21
2016/9/30,141097,港北区,大倉山七丁目,14,29,13,16
2016/9/30,141097,港北区,大倉山七丁目,15,30,18,12
2016/9/30,141097,港北区,大倉山七丁目,16,32,16,16
2016/9/30,141097,港北区,大倉山七丁目,17,38,23,15
2016/9/30,141097,港北区,大倉山七丁目,18,35,17,18
2016/9/30,141097,港北区,大倉山七丁目,19,32,19,13
2016/9/30,141097,港北区,大倉山七丁目,20,35,19,16
2016/9/30,141097,港北区,大倉山七丁目,21,33,14,19
2016/9/30,141097,港北区,大倉山七丁目,22,46,19,27
2016/9/30,141097,港北区,大倉山七丁目,23,28,15,13
2016/9/30,141097,港北区,大倉山七丁目,24,43,19,24
2016/9/30,141097,港北区,大倉山七丁目,25,44,25,19
2016/9/30,141097,港北区,大倉山七丁目,26,30,14,16
2016/9/30,141097,港北区,大倉山七丁目,27,30,15,15
2016/9/30,141097,港北区,大倉山七丁目,28,25,12,13
2016/9/30,141097,港北区,大倉山七丁目,29,26,16,10
2016/9/30,141097,港北区,大倉山七丁目,30,34,22,12
2016/9/30,141097,港北区,大倉山七丁目,31,40,19,21
2016/9/30,141097,港北区,大倉山七丁目,32,32,17,15
2016/9/30,141097,港北区,大倉山七丁目,33,44,26,18
2016/9/30,141097,港北区,大倉山七丁目,34,37,20,17
2016/9/30,141097,港北区,大倉山七丁目,35,34,18,16
2016/9/30,141097,港北区,大倉山七丁目,36,41,25,16
2016/9/30,141097,港北区,大倉山七丁目,37,49,26,23
2016/9/30,141097,港北区,大倉山七丁目,38,54,23,31
2016/9/30,141097,港北区,大倉山七丁目,39,47,23,24
2016/9/30,141097,港北区,大倉山七丁目,40,64,34,30
2016/9/30,141097,港北区,大倉山七丁目,41,41,18,23
2016/9/30,141097,港北区,大倉山七丁目,42,38,15,23
2016/9/30,141097,港北区,大倉山七丁目,43,36,18,18
2016/9/30,141097,港北区,大倉山七丁目,44,52,25,27
2016/9/30,141097,港北区,大倉山七丁目,45,57,35,22
2016/9/30,141097,港北区,大倉山七丁目,46,62,32,30
2016/9/30,141097,港北区,大倉山七丁目,47,50,22,28
2016/9/30,141097,港北区,大倉山七丁目,48,58,21,37
2016/9/30,141097,港北区,大倉山七丁目,49,43,17,26
2016/9/30,141097,港北区,大倉山七丁目,50,43,20,23
2016/9/30,141097,港北区,大倉山七丁目,51,57,28,29
2016/9/30,141097,港北区,大倉山七丁目,52,57,35,22
2016/9/30,141097,港北区,大倉山七丁目,53,55,25,30
2016/9/30,141097,港北区,大倉山七丁目,54,53,28,25
2016/9/30,141097,港北区,大倉山七丁目,55,58,25,33
2016/9/30,141097,港北区,大倉山七丁目,56,54,32,22
2016/9/30,141097,港北区,大倉山七丁目,57,44,22,22
2016/9/30,141097,港北区,大倉山七丁目,58,29,12,17
2016/9/30,141097,港北区,大倉山七丁目,59,32,19,13
2016/9/30,141097,港北区,大倉山七丁目,60,33,18,15
2016/9/30,141097,港北区,大倉山七丁目,61,35,21,14
2016/9/30,141097,港北区,大倉山七丁目,62,35,16,19
2016/9/30,141097,港北区,大倉山七丁目,63,30,17,13
2016/9/30,141097,港北区,大倉山七丁目,64,23,12,11
2016/9/30,141097,港北区,大倉山七丁目,65,23,13,10
2016/9/30,141097,港北区,大倉山七丁目,66,23,9,14
2016/9/30,141097,港北区,大倉山七丁目,67,29,14,15
2016/9/30,141097,港北区,大倉山七丁目,68,35,17,18
2016/9/30,141097,港北区,大倉山七丁目,69,39,19,20
2016/9/30,141097,港北区,大倉山七丁目,70,16,7,9
2016/9/30,141097,港北区,大倉山七丁目,71,24,13,11
2016/9/30,141097,港北区,大倉山七丁目,72,14,9,5
2016/9/30,141097,港北区,大倉山七丁目,73,19,12,7
2016/9/30,141097,港北区,大倉山七丁目,74,21,10,11
2016/9/30,141097,港北区,大倉山七丁目,75,19,8,11
2016/9/30,141097,港北区,大倉山七丁目,76,19,8,11
2016/9/30,141097,港北区,大倉山七丁目,77,10,4,6
2016/9/30,141097,港北区,大倉山七丁目,78,15,5,10
2016/9/30,141097,港北区,大倉山七丁目,79,21,11,10
2016/9/30,141097,港北区,大倉山七丁目,80,23,10,13
2016/9/30,141097,港北区,大倉山七丁目,81,19,6,13
2016/9/30,141097,港北区,大倉山七丁目,82,24,8,16
2016/9/30,141097,港北区,大倉山七丁目,83,11,4,7
2016/9/30,141097,港北区,大倉山七丁目,84,19,8,11
2016/9/30,141097,港北区,大倉山七丁目,85,13,0,13
2016/9/30,141097,港北区,大倉山七丁目,86,13,3,10
2016/9/30,141097,港北区,大倉山七丁目,87,14,6,8
2016/9/30,141097,港北区,大倉山七丁目,88,11,6,5
2016/9/30,141097,港北区,大倉山七丁目,89,5,3,2
2016/9/30,141097,港北区,大倉山七丁目,90,6,3,3
2016/9/30,141097,港北区,大倉山七丁目,91,7,1,6
2016/9/30,141097,港北区,大倉山七丁目,92,5,3,2
2016/9/30,141097,港北区,大倉山七丁目,93,1,1,0
2016/9/30,141097,港北区,大倉山七丁目,94,2,0,2
2016/9/30,141097,港北区,大倉山七丁目,95,0,0,0
2016/9/30,141097,港北区,大倉山七丁目,96,0,0,0
2016/9/30,141097,港北区,大倉山七丁目,97,1,0,1
2016/9/30,141097,港北区,大倉山七丁目,98,0,0,0
2016/9/30,141097,港北区,大倉山七丁目,99,0,0,0
2016/9/30,141097,港北区,大倉山七丁目,100,1,0,1
